"","year","state","handgun","long_gun","other","multiple * 2","Total_sales"
"1",2020,"Alabama",31103,28933,1855,2776,64667
"2",2020,"Alaska",3658,3822,430,466,8376
"3",2020,"Arizona",25093,14562,1942,2790,44387
"4",2020,"Arkansas",10987,12719,587,1020,25313
"5",2020,"California",59909,39389,6932,0,106230
"6",2020,"Colorado",25577,19716,2132,4584,52009
"7",2020,"Connecticut",6741,2694,1682,0,11117
"8",2020,"Delaware",3281,2610,200,350,6441
"9",2020,"District of Columbia",322,17,0,2,341
"10",2020,"Florida",81564,40115,5594,7466,134739
"11",2020,"Georgia",28405,20236,1326,2112,52079
"12",2020,"Guam",182,71,22,22,297
"13",2020,"Hawaii",0,0,0,0,0
"14",2020,"Idaho",9354,9550,809,952,20665
"15",2020,"Illinois",29133,16557,0,3400,49090
"16",2020,"Indiana",30336,21852,2192,2560,56940
"17",2020,"Iowa",312,4678,70,22,5082
"18",2020,"Kansas",9708,9941,893,1164,21706
"19",2020,"Kentucky",19170,17438,765,1846,39219
"20",2020,"Louisiana",19311,18379,1465,1930,41085
"21",2020,"Maine",5001,5320,434,524,11279
"22",2020,"Mariana Islands",13,11,5,0,29
"23",2020,"Maryland",10338,9565,407,24,20334
"24",2020,"Massachusetts",7790,3882,1067,626,13365
"25",2020,"Michigan",33647,29180,3121,2194,68142
"26",2020,"Minnesota",15976,14943,1658,1340,33917
"27",2020,"Mississippi",14651,16554,709,1338,33252
"28",2020,"Missouri",29358,26348,2683,3060,61449
"29",2020,"Montana",5858,7265,405,774,14302
"30",2020,"Nebraska",297,3662,39,16,4014
"31",2020,"Nevada",8205,4599,481,1058,14343
"32",2020,"New Hampshire",7660,4811,285,0,12756
"33",2020,"New Jersey",12667,7473,794,0,20934
"34",2020,"New Mexico",8979,6931,752,964,17626
"35",2020,"New York",10486,24664,3145,734,39029
"36",2020,"North Carolina",2647,28052,1607,460,32766
"37",2020,"North Dakota",2784,4076,217,270,7347
"38",2020,"Ohio",33723,27057,1804,2888,65472
"39",2020,"Oklahoma",18791,17433,2045,2254,40523
"40",2020,"Oregon",21533,16161,0,12,37706
"41",2020,"Pennsylvania",62948,29262,41,0,92251
"42",2020,"Puerto Rico",3569,241,72,86,3968
"43",2020,"Rhode Island",1794,1081,110,686,3671
"44",2020,"South Carolina",17908,13367,1011,1348,33634
"45",2020,"South Dakota",4259,5814,382,406,10861
"46",2020,"Tennessee",40019,32201,2195,0,74415
"47",2020,"Texas",79774,58650,5211,7144,150779
"48",2020,"Utah",9296,9136,695,0,19127
"49",2020,"Vermont",2351,2413,174,274,5212
"50",2020,"Virgin Islands",44,3,1,2,50
"51",2020,"Virginia",36502,26668,4634,0,67804
"52",2020,"Washington",27422,18368,4047,114,49951
"53",2020,"West Virginia",8706,10939,412,922,20979
"54",2020,"Wisconsin",23321,17480,1537,120,42458
"55",2020,"Wyoming",3998,4137,280,376,8791
"56",2020,"Alabama",27765,25924,1931,3038,58658
"57",2020,"Alaska",3474,3878,461,602,8415
"58",2020,"Arizona",25906,14698,2157,3208,45969
"59",2020,"Arkansas",10069,12954,599,1010,24632
"60",2020,"California",56793,37256,7391,0,101440
"61",2020,"Colorado",27091,20410,2421,4694,54616
"62",2020,"Connecticut",7253,2986,2115,0,12354
"63",2020,"Delaware",3863,2777,198,348,7186
"64",2020,"District of Columbia",332,11,0,10,353
"65",2020,"Florida",84366,40575,6090,8352,139383
"66",2020,"Georgia",28102,19042,1358,2410,50912
"67",2020,"Guam",205,99,32,18,354
"68",2020,"Hawaii",0,0,0,0,0
"69",2020,"Idaho",8946,9372,892,1110,20320
"70",2020,"Illinois",29335,17557,0,3780,50672
"71",2020,"Indiana",29416,24425,2231,2766,58838
"72",2020,"Iowa",365,5751,84,8,6208
"73",2020,"Kansas",10569,10435,981,1180,23165
"74",2020,"Kentucky",16578,17091,806,1640,36115
"75",2020,"Louisiana",17819,18448,1507,1932,39706
"76",2020,"Maine",4801,6062,436,610,11909
"77",2020,"Mariana Islands",10,3,0,0,13
"78",2020,"Maryland",10864,11038,764,18,22684
"79",2020,"Massachusetts",8817,4397,1216,784,15214
"80",2020,"Michigan",35190,35065,2866,2358,75479
"81",2020,"Minnesota",16316,17448,1506,1580,36850
"82",2020,"Mississippi",12893,15003,757,1282,29935
"83",2020,"Missouri",27413,27727,2932,2980,61052
"84",2020,"Montana",5060,6609,418,810,12897
"85",2020,"Nebraska",380,4117,45,16,4558
"86",2020,"Nevada",9055,4507,548,1130,15240
"87",2020,"New Hampshire",9055,5356,248,0,14659
"88",2020,"New Jersey",13826,8053,869,0,22748
"89",2020,"New Mexico",7277,5495,715,830,14317
"90",2020,"New York",10393,28951,3768,810,43922
"91",2020,"North Carolina",2770,28807,1852,482,33911
"92",2020,"North Dakota",2738,4153,211,350,7452
"93",2020,"Ohio",37382,32959,2122,3726,76189
"94",2020,"Oklahoma",18163,16961,1890,2508,39522
"95",2020,"Oregon",21990,15648,0,8,37646
"96",2020,"Pennsylvania",75428,34686,29,0,110143
"97",2020,"Puerto Rico",2883,217,60,52,3212
"98",2020,"Rhode Island",2033,1419,158,1050,4660
"99",2020,"South Carolina",19010,13569,1136,1574,35289
"100",2020,"South Dakota",4302,6560,362,598,11822
"101",2020,"Tennessee",37467,31625,2298,0,71390
"102",2020,"Texas",78827,56265,5504,8012,148608
"103",2020,"Utah",9582,9044,764,0,19390
"104",2020,"Vermont",2104,2445,217,330,5096
"105",2020,"Virgin Islands",37,4,0,0,41
"106",2020,"Virginia",35909,26638,4874,0,67421
"107",2020,"Washington",27563,18592,4350,130,50635
"108",2020,"West Virginia",8086,11767,483,944,21280
"109",2020,"Wisconsin",25742,21825,1596,142,49305
"110",2020,"Wyoming",3685,4452,308,496,8941
"111",2020,"Alabama",24084,17964,1698,2208,45954
"112",2020,"Alaska",3209,3210,348,376,7143
"113",2020,"Arizona",24964,12288,1951,3524,42727
"114",2020,"Arkansas",8931,9386,567,842,19726
"115",2020,"California",65376,40286,8319,0,113981
"116",2020,"Colorado",25802,17699,2102,3884,49487
"117",2020,"Connecticut",6821,2764,1785,0,11370
"118",2020,"Delaware",3951,2489,188,316,6944
"119",2020,"District of Columbia",470,11,0,10,491
"120",2020,"Florida",83816,32346,5782,6990,128934
"121",2020,"Georgia",26383,14710,1145,2200,44438
"122",2020,"Guam",221,88,32,24,365
"123",2020,"Hawaii",0,0,0,0,0
"124",2020,"Idaho",7439,8153,613,700,16905
"125",2020,"Illinois",28277,14905,0,3280,46462
"126",2020,"Indiana",27979,18181,2216,2086,50462
"127",2020,"Iowa",218,4151,50,10,4429
"128",2020,"Kansas",8659,7551,814,972,17996
"129",2020,"Kentucky",15816,12804,763,1586,30969
"130",2020,"Louisiana",15180,13153,1312,1600,31245
"131",2020,"Maine",5087,8215,375,582,14259
"132",2020,"Mariana Islands",15,12,1,0,28
"133",2020,"Maryland",10843,9873,159,12,20887
"134",2020,"Massachusetts",8354,4364,1112,744,14574
"135",2020,"Michigan",34940,28266,2745,2126,68077
"136",2020,"Minnesota",16941,20404,1317,1560,40222
"137",2020,"Mississippi",10982,10229,655,900,22766
"138",2020,"Missouri",25340,22636,2386,2768,53130
"139",2020,"Montana",4429,7087,374,622,12512
"140",2020,"Nebraska",234,2960,30,10,3234
"141",2020,"Nevada",8764,3693,496,1032,13985
"142",2020,"New Hampshire",7906,5243,177,0,13326
"143",2020,"New Jersey",13275,7171,851,0,21297
"144",2020,"New Mexico",7814,5189,674,778,14455
"145",2020,"New York",10541,28281,3588,1026,43436
"146",2020,"North Carolina",2421,21403,1663,462,25949
"147",2020,"North Dakota",2326,4589,158,264,7337
"148",2020,"Ohio",35332,23048,1962,3226,63568
"149",2020,"Oklahoma",14860,11904,1513,1864,30141
"150",2020,"Oregon",22277,14255,0,6,36538
"151",2020,"Pennsylvania",73607,29581,45,0,103233
"152",2020,"Puerto Rico",3714,252,65,88,4119
"153",2020,"Rhode Island",2143,1359,143,916,4561
"154",2020,"South Carolina",17032,10168,1035,1286,29521
"155",2020,"South Dakota",3537,6336,243,474,10590
"156",2020,"Tennessee",33275,22568,1973,0,57816
"157",2020,"Texas",72591,44620,5042,6474,128727
"158",2020,"Utah",7356,6378,590,0,14324
"159",2020,"Vermont",2139,2723,176,278,5316
"160",2020,"Virgin Islands",37,4,0,0,41
"161",2020,"Virginia",37867,22986,4606,0,65459
"162",2020,"Washington",26765,17191,4170,138,48264
"163",2020,"West Virginia",6934,8559,398,838,16729
"164",2020,"Wisconsin",26028,19720,1353,104,47205
"165",2020,"Wyoming",2616,3207,210,332,6365
"166",2020,"Alabama",23455,17369,1633,1962,44419
"167",2020,"Alaska",3275,3333,345,402,7355
"168",2020,"Arizona",23996,12094,1963,3746,41799
"169",2020,"Arkansas",9214,8003,505,766,18488
"170",2020,"California",61258,36638,7815,0,105711
"171",2020,"Colorado",24260,15873,1919,3442,45494
"172",2020,"Connecticut",6101,2284,1443,0,9828
"173",2020,"Delaware",3501,1909,176,282,5868
"174",2020,"District of Columbia",531,11,0,2,544
"175",2020,"Florida",76685,29317,5523,6348,117873
"176",2020,"Georgia",24175,12797,1112,2996,41080
"177",2020,"Guam",150,54,35,30,269
"178",2020,"Hawaii",0,0,0,0,0
"179",2020,"Idaho",7297,7426,629,764,16116
"180",2020,"Illinois",27645,13848,0,3008,44501
"181",2020,"Indiana",26530,15978,1955,1832,46295
"182",2020,"Iowa",227,3541,56,4,3828
"183",2020,"Kansas",7897,6489,662,836,15884
"184",2020,"Kentucky",16006,10674,715,1342,28737
"185",2020,"Louisiana",15581,12661,1283,1658,31183
"186",2020,"Maine",4758,6249,373,552,11932
"187",2020,"Mariana Islands",14,11,2,6,33
"188",2020,"Maryland",9575,8547,282,4,18408
"189",2020,"Massachusetts",6889,3754,878,572,12093
"190",2020,"Michigan",32590,25496,2391,1734,62211
"191",2020,"Minnesota",16169,19127,1292,1426,38014
"192",2020,"Mississippi",10668,8825,651,862,21006
"193",2020,"Missouri",24614,17708,2216,2176,46714
"194",2020,"Montana",4903,6148,319,856,12226
"195",2020,"Nebraska",127,2362,23,6,2518
"196",2020,"Nevada",8773,3700,505,888,13866
"197",2020,"New Hampshire",6974,4420,189,0,11583
"198",2020,"New Jersey",12591,7274,735,0,20600
"199",2020,"New Mexico",7960,5067,709,676,14412
"200",2020,"New York",9928,25663,3370,930,39891
"201",2020,"North Carolina",2274,19325,1531,376,23506
"202",2020,"North Dakota",2339,3879,134,244,6596
"203",2020,"Ohio",32432,19759,1717,2684,56592
"204",2020,"Oklahoma",14820,11176,1500,2110,29606
"205",2020,"Oregon",20804,13091,0,12,33907
"206",2020,"Pennsylvania",68109,25277,46,0,93432
"207",2020,"Puerto Rico",2560,261,64,76,2961
"208",2020,"Rhode Island",2001,1165,133,696,3995
"209",2020,"South Carolina",14993,9264,915,966,26138
"210",2020,"South Dakota",3588,4621,200,332,8741
"211",2020,"Tennessee",31341,19732,1661,0,52734
"212",2020,"Texas",68804,46463,4888,5856,126011
"213",2020,"Utah",6762,5896,529,0,13187
"214",2020,"Vermont",1973,2380,147,240,4740
"215",2020,"Virgin Islands",34,1,0,2,37
"216",2020,"Virginia",31327,19565,4105,0,54997
"217",2020,"Washington",26363,15035,4062,108,45568
"218",2020,"West Virginia",6635,7065,380,734,14814
"219",2020,"Wisconsin",25970,17806,1448,92,45316
"220",2020,"Wyoming",2722,3247,186,432,6587
"221",2020,"Alabama",26449,16913,1943,2150,47455
"222",2020,"Alaska",4088,4113,404,508,9113
"223",2020,"Arizona",25375,12472,2233,4632,44712
"224",2020,"Arkansas",9821,7421,619,778,18639
"225",2020,"California",65196,38505,8409,0,112110
"226",2020,"Colorado",25765,16476,1948,3220,47409
"227",2020,"Connecticut",5952,2014,1616,0,9582
"228",2020,"Delaware",3402,1919,181,222,5724
"229",2020,"District of Columbia",550,5,0,2,557
"230",2020,"Florida",85345,30914,6509,6386,129154
"231",2020,"Georgia",26176,12198,1349,3642,43365
"232",2020,"Guam",151,39,57,18,265
"233",2020,"Hawaii",0,0,0,0,0
"234",2020,"Idaho",7860,6811,620,746,16037
"235",2020,"Illinois",28864,13330,0,2916,45110
"236",2020,"Indiana",28843,16235,2226,2076,49380
"237",2020,"Iowa",242,3223,54,12,3531
"238",2020,"Kansas",8851,6423,781,868,16923
"239",2020,"Kentucky",18531,10985,842,1402,31760
"240",2020,"Louisiana",16826,10171,1568,1686,30251
"241",2020,"Maine",4734,4555,361,484,10134
"242",2020,"Mariana Islands",9,6,1,0,16
"243",2020,"Maryland",8270,7807,248,8,16333
"244",2020,"Massachusetts",6756,3557,748,608,11669
"245",2020,"Michigan",35892,23104,2709,1810,63515
"246",2020,"Minnesota",17297,15193,1311,1262,35063
"247",2020,"Mississippi",15129,10518,928,1170,27745
"248",2020,"Missouri",26351,17461,2343,2230,48385
"249",2020,"Montana",5066,5441,340,510,11357
"250",2020,"Nebraska",140,2280,32,4,2456
"251",2020,"Nevada",9541,3884,575,976,14976
"252",2020,"New Hampshire",6952,4034,213,2,11201
"253",2020,"New Jersey",10002,6258,518,0,16778
"254",2020,"New Mexico",8580,5360,780,756,15476
"255",2020,"New York",10163,22460,3426,1020,37069
"256",2020,"North Carolina",2534,18885,1603,332,23354
"257",2020,"North Dakota",2503,3428,164,206,6301
"258",2020,"Ohio",37224,19937,2099,2712,61972
"259",2020,"Oklahoma",15728,10666,1672,1902,29968
"260",2020,"Oregon",21080,12694,0,24,33798
"261",2020,"Pennsylvania",69325,24361,37,0,93723
"262",2020,"Puerto Rico",2441,250,73,60,2824
"263",2020,"Rhode Island",1842,1081,125,702,3750
"264",2020,"South Carolina",17111,9137,1043,1054,28345
"265",2020,"South Dakota",3700,4105,235,304,8344
"266",2020,"Tennessee",35007,21069,1837,0,57913
"267",2020,"Texas",77807,43770,5975,5934,133486
"268",2020,"Utah",6483,5303,581,0,12367
"269",2020,"Vermont",2128,1898,183,210,4419
"270",2020,"Virgin Islands",22,2,1,0,25
"271",2020,"Virginia",36314,20016,4525,0,60855
"272",2020,"Washington",28536,14497,4259,64,47356
"273",2020,"West Virginia",7487,6958,455,690,15590
"274",2020,"Wisconsin",28102,15908,1485,78,45573
"275",2020,"Wyoming",3080,3188,220,256,6744
"276",2020,"Alabama",34909,17250,2498,2340,56997
"277",2020,"Alaska",4949,3779,435,566,9729
"278",2020,"Arizona",31040,12361,2411,5732,51544
"279",2020,"Arkansas",12391,7322,738,864,21315
"280",2020,"California",67672,38618,7530,0,113820
"281",2020,"Colorado",29171,15184,2077,3390,49822
"282",2020,"Connecticut",6815,2062,1791,0,10668
"283",2020,"Delaware",4034,1840,249,284,6407
"284",2020,"District of Columbia",296,11,0,0,307
"285",2020,"Florida",106745,33102,7751,7664,155262
"286",2020,"Georgia",38413,13344,1700,6736,60193
"287",2020,"Guam",227,85,54,38,404
"288",2020,"Hawaii",0,0,0,0,0
"289",2020,"Idaho",8813,6337,752,776,16678
"290",2020,"Illinois",31853,12250,0,2720,46823
"291",2020,"Indiana",32970,15066,2395,2166,52597
"292",2020,"Iowa",248,2685,45,12,2990
"293",2020,"Kansas",10300,6071,833,830,18034
"294",2020,"Kentucky",20962,10578,947,1518,34005
"295",2020,"Louisiana",24074,11374,1980,2526,39954
"296",2020,"Maine",5163,4049,398,514,10124
"297",2020,"Mariana Islands",13,6,1,2,22
"298",2020,"Maryland",7905,8023,347,8,16283
"299",2020,"Massachusetts",6238,3114,730,514,10596
"300",2020,"Michigan",44270,21710,2909,2140,71029
"301",2020,"Minnesota",17856,11371,1397,1272,31896
"302",2020,"Mississippi",19196,8971,1119,1146,30432
"303",2020,"Missouri",31991,17146,2753,2686,54576
"304",2020,"Montana",5472,4926,339,578,11315
"305",2020,"Nebraska",135,1929,34,8,2106
"306",2020,"Nevada",11920,3949,658,1188,17715
"307",2020,"New Hampshire",7918,3788,213,2,11921
"308",2020,"New Jersey",7656,6172,448,0,14276
"309",2020,"New Mexico",10102,5084,768,894,16848
"310",2020,"New York",11400,23105,4019,1038,39562
"311",2020,"North Carolina",2865,20322,1965,392,25544
"312",2020,"North Dakota",2702,2942,170,256,6070
"313",2020,"Ohio",43645,18865,2325,2868,67703
"314",2020,"Oklahoma",19294,10955,2027,2328,34604
"315",2020,"Oregon",22479,11897,0,14,34390
"316",2020,"Pennsylvania",77854,22276,68,0,100198
"317",2020,"Puerto Rico",2283,256,107,68,2714
"318",2020,"Rhode Island",2079,1142,139,812,4172
"319",2020,"South Carolina",23255,8726,1231,1252,34464
"320",2020,"South Dakota",3609,3222,254,328,7413
"321",2020,"Tennessee",42011,20831,2075,0,64917
"322",2020,"Texas",96689,41060,6431,6732,150912
"323",2020,"Utah",8314,5447,744,0,14505
"324",2020,"Vermont",2373,1739,199,244,4555
"325",2020,"Virgin Islands",48,4,0,0,52
"326",2020,"Virginia",44801,19538,5588,0,69927
"327",2020,"Washington",33892,14006,4980,108,52986
"328",2020,"West Virginia",9331,6358,479,836,17004
"329",2020,"Wisconsin",26890,12518,1273,104,40785
"330",2020,"Wyoming",3237,2950,207,294,6688
"331",2020,"Alabama",47159,20120,2604,3464,73347
"332",2020,"Alaska",4785,3091,451,468,8795
"333",2020,"Arizona",43291,14267,2769,7836,68163
"334",2020,"Arkansas",15520,7820,785,926,25051
"335",2020,"California",76210,40933,8487,0,125630
"336",2020,"Colorado",35381,16998,2250,3990,58619
"337",2020,"Connecticut",6943,2196,2178,0,11317
"338",2020,"Delaware",5303,2116,204,366,7989
"339",2020,"District of Columbia",217,0,0,2,219
"340",2020,"Florida",133285,39111,7341,9692,189429
"341",2020,"Georgia",46989,14779,1663,6874,70305
"342",2020,"Guam",243,100,36,24,403
"343",2020,"Hawaii",0,0,0,0,0
"344",2020,"Idaho",10802,7430,801,948,19981
"345",2020,"Illinois",49101,14913,0,4204,68218
"346",2020,"Indiana",40492,16560,2561,2492,62105
"347",2020,"Iowa",319,4009,80,16,4424
"348",2020,"Kansas",12829,6276,853,954,20912
"349",2020,"Kentucky",27051,11707,993,1914,41665
"350",2020,"Louisiana",28289,11116,1774,2288,43467
"351",2020,"Maine",6583,4059,468,632,11742
"352",2020,"Mariana Islands",10,6,0,2,18
"353",2020,"Maryland",8818,9524,464,34,18840
"354",2020,"Massachusetts",7923,3881,921,814,13539
"355",2020,"Michigan",51216,23784,3149,2650,80799
"356",2020,"Minnesota",17758,12316,1435,1328,32837
"357",2020,"Mississippi",23505,9291,886,1316,34998
"358",2020,"Missouri",38153,17472,2786,2614,61025
"359",2020,"Montana",6573,5803,389,626,13391
"360",2020,"Nebraska",179,2474,34,2,2689
"361",2020,"Nevada",14420,4220,656,1242,20538
"362",2020,"New Hampshire",9911,4211,198,4,14324
"363",2020,"New Jersey",6921,6077,457,0,13455
"364",2020,"New Mexico",11828,5984,880,1002,19694
"365",2020,"New York",11585,31003,4735,1304,48627
"366",2020,"North Carolina",3380,25843,2162,426,31811
"367",2020,"North Dakota",3426,3373,201,282,7282
"368",2020,"Ohio",54811,21686,2452,3876,82825
"369",2020,"Oklahoma",24400,11222,1987,2424,40033
"370",2020,"Oregon",27187,13974,0,16,41177
"371",2020,"Pennsylvania",90652,24029,66,0,114747
"372",2020,"Puerto Rico",2838,302,153,68,3361
"373",2020,"Rhode Island",2453,1702,177,1108,5440
"374",2020,"South Carolina",30837,9991,1338,1726,43892
"375",2020,"South Dakota",4487,3492,276,396,8651
"376",2020,"Tennessee",50593,21516,2293,0,74402
"377",2020,"Texas",121926,45845,6857,7936,182564
"378",2020,"Utah",10796,6292,761,0,17849
"379",2020,"Vermont",2702,1872,201,226,5001
"380",2020,"Virgin Islands",29,3,0,2,34
"381",2020,"Virginia",55177,21748,6338,0,83263
"382",2020,"Washington",35924,15646,7431,162,59163
"383",2020,"West Virginia",11554,7043,528,836,19961
"384",2020,"Wisconsin",35081,13619,1560,102,50362
"385",2020,"Wyoming",3966,2946,238,340,7490
"386",2020,"Alabama",32394,13899,1468,2032,49793
"387",2020,"Alaska",4469,3196,429,438,8532
"388",2020,"Arizona",28089,11334,2053,4804,46280
"389",2020,"Arkansas",11572,7005,528,906,20011
"390",2020,"California",50811,28550,6499,0,85860
"391",2020,"Colorado",27297,15043,1998,2816,47154
"392",2020,"Connecticut",4654,1673,1714,0,8041
"393",2020,"Delaware",2899,1238,165,252,4554
"394",2020,"District of Columbia",109,1,0,0,110
"395",2020,"Florida",73691,22529,5156,5580,106956
"396",2020,"Georgia",34434,11489,1139,3060,50122
"397",2020,"Guam",207,88,30,18,343
"398",2020,"Hawaii",0,0,0,0,0
"399",2020,"Idaho",8228,6848,635,712,16423
"400",2020,"Illinois",26854,9959,0,2212,39025
"401",2020,"Indiana",30133,14420,2221,2208,48982
"402",2020,"Iowa",287,2825,77,18,3207
"403",2020,"Kansas",10020,5595,869,972,17456
"404",2020,"Kentucky",20881,11275,823,1866,34845
"405",2020,"Louisiana",20064,8025,1174,1646,30909
"406",2020,"Maine",5374,3724,515,594,10207
"407",2020,"Mariana Islands",8,4,1,0,13
"408",2020,"Maryland",5975,6775,207,40,12997
"409",2020,"Massachusetts",5743,2665,889,686,9983
"410",2020,"Michigan",39342,20339,2949,2284,64914
"411",2020,"Minnesota",13770,11706,1152,1228,27856
"412",2020,"Mississippi",18313,7363,555,1092,27323
"413",2020,"Missouri",31302,16484,2308,2582,52676
"414",2020,"Montana",5835,5797,362,588,12582
"415",2020,"Nebraska",120,2026,23,8,2177
"416",2020,"Nevada",10720,3997,710,1208,16635
"417",2020,"New Hampshire",7797,3760,211,6,11774
"418",2020,"New Jersey",5316,3859,414,0,9589
"419",2020,"New Mexico",9638,4888,749,988,16263
"420",2020,"New York",5312,14212,2581,760,22865
"421",2020,"North Carolina",2365,18508,1631,476,22980
"422",2020,"North Dakota",2734,2740,183,258,5915
"423",2020,"Ohio",37486,17996,2268,3048,60798
"424",2020,"Oklahoma",18787,9863,1571,2132,32353
"425",2020,"Oregon",22539,13415,0,20,35974
"426",2020,"Pennsylvania",56455,16255,85,0,72795
"427",2020,"Puerto Rico",1252,135,55,50,1492
"428",2020,"Rhode Island",1571,926,101,742,3340
"429",2020,"South Carolina",22675,7524,1154,1114,32467
"430",2020,"South Dakota",3342,3037,199,338,6916
"431",2020,"Tennessee",38522,17799,1869,0,58190
"432",2020,"Texas",83977,36456,5393,6284,132110
"433",2020,"Utah",7550,5265,559,0,13374
"434",2020,"Vermont",2660,1948,194,286,5088
"435",2020,"Virgin Islands",9,0,0,0,9
"436",2020,"Virginia",36930,16775,4568,0,58273
"437",2020,"Washington",26162,12578,4963,140,43843
"438",2020,"West Virginia",10193,7152,532,1088,18965
"439",2020,"Wisconsin",25506,11577,1226,114,38423
"440",2020,"Wyoming",2902,2591,255,326,6074
"441",2020,"Alabama",28951,12512,1455,2544,45462
"442",2020,"Alaska",3942,3275,510,490,8217
"443",2020,"Arizona",33391,13143,2369,6242,55145
"444",2020,"Arkansas",13814,8463,612,1356,24245
"445",2020,"California",59219,31759,6330,0,97308
"446",2020,"Colorado",29865,16199,2133,4148,52345
"447",2020,"Connecticut",4921,1802,2294,0,9017
"448",2020,"Delaware",3572,1308,185,208,5273
"449",2020,"District of Columbia",100,1,0,0,101
"450",2020,"Florida",84431,26731,4897,6902,122961
"451",2020,"Georgia",33720,11724,1162,3078,49684
"452",2020,"Guam",132,59,23,16,230
"453",2020,"Hawaii",0,0,0,0,0
"454",2020,"Idaho",9248,7050,696,1042,18036
"455",2020,"Illinois",30500,11184,0,2564,44248
"456",2020,"Indiana",29904,14843,2332,2480,49559
"457",2020,"Iowa",296,3284,79,16,3675
"458",2020,"Kansas",10417,5632,863,1126,18038
"459",2020,"Kentucky",20712,12196,820,2346,36074
"460",2020,"Louisiana",18563,7462,1117,1778,28920
"461",2020,"Maine",6054,3835,594,678,11161
"462",2020,"Mariana Islands",7,1,1,0,9
"463",2020,"Maryland",5717,8524,101,36,14378
"464",2020,"Massachusetts",1407,674,710,104,2895
"465",2020,"Michigan",23375,13600,2507,1832,41314
"466",2020,"Minnesota",13792,10295,1371,1182,26640
"467",2020,"Mississippi",17677,7256,586,1312,26831
"468",2020,"Missouri",32009,17962,2470,3282,55723
"469",2020,"Montana",6010,5399,454,888,12751
"470",2020,"Nebraska",146,2177,47,18,2388
"471",2020,"Nevada",12225,3870,619,1390,18104
"472",2020,"New Hampshire",8801,4512,259,0,13572
"473",2020,"New Jersey",4388,4266,311,0,8965
"474",2020,"New Mexico",7439,3798,648,746,12631
"475",2020,"New York",2853,16007,2918,632,22410
"476",2020,"North Carolina",2199,20928,1705,704,25536
"477",2020,"North Dakota",3041,2898,204,340,6483
"478",2020,"Ohio",37486,18560,2295,3432,61773
"479",2020,"Oklahoma",21398,11308,1617,2716,37039
"480",2020,"Oregon",25187,13572,0,6,38765
"481",2020,"Pennsylvania",54041,14778,40,0,68859
"482",2020,"Puerto Rico",76,10,7,6,99
"483",2020,"Rhode Island",1841,1247,126,824,4038
"484",2020,"South Carolina",21071,7502,866,1398,30837
"485",2020,"South Dakota",4171,3177,282,412,8042
"486",2020,"Tennessee",38309,19001,1974,0,59284
"487",2020,"Texas",93980,40921,5668,8980,149549
"488",2020,"Utah",9834,6501,676,0,17011
"489",2020,"Vermont",3081,2142,223,302,5748
"490",2020,"Virgin Islands",2,0,0,0,2
"491",2020,"Virginia",40444,19116,4949,0,64509
"492",2020,"Washington",29785,12837,4428,154,47204
"493",2020,"West Virginia",10120,7913,480,1310,19823
"494",2020,"Wisconsin",27220,11806,1406,98,40530
"495",2020,"Wyoming",3988,3102,327,440,7857
"496",2020,"Alabama",34897,17850,1583,3488,57818
"497",2020,"Alaska",4657,3819,487,772,9735
"498",2020,"Arizona",46377,19346,2433,9692,77848
"499",2020,"Arkansas",15304,8968,600,1770,26642
"500",2020,"California",81543,48616,5041,0,135200
"501",2020,"Colorado",43322,22756,2086,6484,74648
"502",2020,"Connecticut",9196,3290,5421,0,17907
"503",2020,"Delaware",4936,2323,190,392,7841
"504",2020,"District of Columbia",148,5,0,2,155
"505",2020,"Florida",117900,38365,5017,12146,173428
"506",2020,"Georgia",44107,16807,1245,4610,66769
"507",2020,"Guam",170,80,11,18,279
"508",2020,"Hawaii",0,0,0,0,0
"509",2020,"Idaho",11611,8193,716,1428,21948
"510",2020,"Illinois",44112,17127,0,4816,66055
"511",2020,"Indiana",45695,22724,2613,4622,75654
"512",2020,"Iowa",378,5778,91,26,6273
"513",2020,"Kansas",16715,8964,889,1904,28472
"514",2020,"Kentucky",28268,15315,937,3230,47750
"515",2020,"Louisiana",25038,10278,1258,2684,39258
"516",2020,"Maine",7794,5310,510,928,14542
"517",2020,"Mariana Islands",4,1,0,0,5
"518",2020,"Maryland",6534,16181,335,154,23204
"519",2020,"Massachusetts",9765,5100,759,1128,16752
"520",2020,"Michigan",50368,28985,2724,4432,86509
"521",2020,"Minnesota",18708,17222,1562,1888,39380
"522",2020,"Mississippi",18567,8714,592,1588,29461
"523",2020,"Missouri",41905,22607,2610,4900,72022
"524",2020,"Montana",6755,5895,500,1104,14254
"525",2020,"Nebraska",217,3623,45,8,3893
"526",2020,"Nevada",13530,4712,483,1754,20479
"527",2020,"New Hampshire",14278,6190,348,0,20816
"528",2020,"New Jersey",4531,6000,286,0,10817
"529",2020,"New Mexico",13558,7181,804,1606,23149
"530",2020,"New York",9257,39906,4288,1138,54589
"531",2020,"North Carolina",2488,31949,2016,818,37271
"532",2020,"North Dakota",4122,3717,246,458,8543
"533",2020,"Ohio",63707,28817,2793,7054,102371
"534",2020,"Oklahoma",25804,13873,1725,3650,45052
"535",2020,"Oregon",33659,18838,0,20,52517
"536",2020,"Pennsylvania",81319,22031,30,0,103380
"537",2020,"Puerto Rico",660,104,34,36,834
"538",2020,"Rhode Island",2533,2303,178,1226,6240
"539",2020,"South Carolina",25288,10790,1017,2144,39239
"540",2020,"South Dakota",5536,4230,337,672,10775
"541",2020,"Tennessee",49546,25157,2954,0,77657
"542",2020,"Texas",147714,61827,5897,16572,232010
"543",2020,"Utah",13908,8665,628,0,23201
"544",2020,"Vermont",3853,2636,238,534,7261
"545",2020,"Virgin Islands",21,2,0,0,23
"546",2020,"Virginia",51801,24208,6848,0,82857
"547",2020,"Washington",32624,20165,5234,222,58245
"548",2020,"West Virginia",11570,8599,564,1874,22607
"549",2020,"Wisconsin",42224,18582,1627,176,62609
"550",2020,"Wyoming",4155,3349,299,488,8291
"551",2020,"Alabama",24590,12531,1225,2434,40780
"552",2020,"Alaska",2560,1839,311,406,5116
"553",2020,"Arizona",16839,8006,1424,2784,29053
"554",2020,"Arkansas",8112,5453,363,1084,15012
"555",2020,"California",35570,22645,4221,0,62436
"556",2020,"Colorado",19931,11285,1505,2298,35019
"557",2020,"Connecticut",5341,1961,3468,0,10770
"558",2020,"Delaware",2103,1386,130,156,3775
"559",2020,"District of Columbia",97,4,0,0,101
"560",2020,"Florida",59653,20306,3748,5420,89127
"561",2020,"Georgia",19173,8207,752,1716,29848
"562",2020,"Guam",161,67,10,14,252
"563",2020,"Hawaii",0,0,0,0,0
"564",2020,"Idaho",5286,4371,420,728,10805
"565",2020,"Illinois",22743,9761,0,1826,34330
"566",2020,"Indiana",25949,12739,1974,2166,42828
"567",2020,"Iowa",220,2419,48,14,2701
"568",2020,"Kansas",7905,5610,653,1008,15176
"569",2020,"Kentucky",15294,8763,668,2192,26917
"570",2020,"Louisiana",12303,6564,734,1340,20941
"571",2020,"Maine",3920,2871,339,432,7562
"572",2020,"Mariana Islands",12,3,0,0,15
"573",2020,"Maryland",4472,5622,140,60,10294
"574",2020,"Massachusetts",5745,2711,538,476,9470
"575",2020,"Michigan",14668,9092,901,648,25309
"576",2020,"Minnesota",11142,9395,990,992,22519
"577",2020,"Mississippi",11638,6114,407,1170,19329
"578",2020,"Missouri",23420,14384,1965,2832,42601
"579",2020,"Montana",3343,3196,293,638,7470
"580",2020,"Nebraska",177,1764,36,14,1991
"581",2020,"Nevada",6215,2706,376,684,9981
"582",2020,"New Hampshire",6031,2740,241,2,9014
"583",2020,"New Jersey",4603,3580,224,0,8407
"584",2020,"New Mexico",7615,4152,633,1086,13486
"585",2020,"New York",9861,13360,2002,516,25739
"586",2020,"North Carolina",1984,13177,1191,740,17092
"587",2020,"North Dakota",2122,2471,166,210,4969
"588",2020,"Ohio",29360,14843,2448,3116,49767
"589",2020,"Oklahoma",16480,8203,1300,2590,28573
"590",2020,"Oregon",16784,10360,0,8,27152
"591",2020,"Pennsylvania",53384,15473,53,0,68910
"592",2020,"Puerto Rico",1540,126,45,32,1743
"593",2020,"Rhode Island",1307,723,108,424,2562
"594",2020,"South Carolina",14700,6120,865,1164,22849
"595",2020,"South Dakota",3359,3195,246,446,7246
"596",2020,"Tennessee",32364,15464,1688,0,49516
"597",2020,"Texas",60512,29259,3956,7326,101053
"598",2020,"Utah",4153,3460,378,0,7991
"599",2020,"Vermont",1870,1514,157,158,3699
"600",2020,"Virgin Islands",33,2,0,2,37
"601",2020,"Virginia",36608,20509,8746,0,65863
"602",2020,"Washington",18044,9505,4021,102,31672
"603",2020,"West Virginia",8200,6163,462,1626,16451
"604",2020,"Wisconsin",17509,11891,1148,150,30698
"605",2020,"Wyoming",2322,1975,170,308,4775
"606",2020,"Alabama",22478,12598,1313,2020,38409
"607",2020,"Alaska",2151,1529,312,284,4276
"608",2020,"Arizona",15126,7087,1475,2044,25732
"609",2020,"Arkansas",6621,5524,435,736,13316
"610",2020,"California",34884,22057,4131,0,61072
"611",2020,"Colorado",19614,11451,1757,2282,35104
"612",2020,"Connecticut",5820,2187,694,0,8701
"613",2020,"Delaware",2096,1524,143,136,3899
"614",2020,"District of Columbia",124,4,0,2,130
"615",2020,"Florida",54985,19973,3957,4976,83891
"616",2020,"Georgia",14422,7886,797,1098,24203
"617",2020,"Guam",155,56,10,16,237
"618",2020,"Hawaii",0,0,0,0,0
"619",2020,"Idaho",4359,3607,496,426,8888
"620",2020,"Illinois",22567,9588,0,1880,34035
"621",2020,"Indiana",22340,12461,2166,1780,38747
"622",2020,"Iowa",198,2030,50,8,2286
"623",2020,"Kansas",6624,5196,702,730,13252
"624",2020,"Kentucky",12022,7558,704,1310,21594
"625",2020,"Louisiana",10706,7687,798,1004,20195
"626",2020,"Maine",3534,2661,351,358,6904
"627",2020,"Mariana Islands",18,6,1,2,27
"628",2020,"Maryland",4283,5213,118,28,9642
"629",2020,"Massachusetts",5182,2833,628,382,9025
"630",2020,"Michigan",11806,8250,941,450,21447
"631",2020,"Minnesota",9445,7565,974,890,18874
"632",2020,"Mississippi",8790,5922,445,712,15869
"633",2020,"Missouri",20436,13149,2065,2198,37848
"634",2020,"Montana",2884,3010,271,448,6613
"635",2020,"Nebraska",110,1923,35,6,2074
"636",2020,"Nevada",5250,2413,356,556,8575
"637",2020,"New Hampshire",5771,2913,341,0,9025
"638",2020,"New Jersey",4349,3639,205,0,8193
"639",2020,"New Mexico",6783,3648,573,960,11964
"640",2020,"New York",10227,12610,2058,448,25343
"641",2020,"North Carolina",1836,12908,1316,496,16556
"642",2020,"North Dakota",1771,2258,158,180,4367
"643",2020,"Ohio",24218,13069,2066,1998,41351
"644",2020,"Oklahoma",14939,8277,1346,1894,26456
"645",2020,"Oregon",15332,9167,0,10,24509
"646",2020,"Pennsylvania",46160,13636,70,0,59866
"647",2020,"Puerto Rico",1559,139,75,82,1855
"648",2020,"Rhode Island",1279,844,118,430,2671
"649",2020,"South Carolina",11488,5795,969,876,19128
"650",2020,"South Dakota",2782,2897,214,316,6209
"651",2020,"Tennessee",28938,14788,1507,0,45233
"652",2020,"Texas",53796,29103,4092,4784,91775
"653",2020,"Utah",3552,2959,387,0,6898
"654",2020,"Vermont",1500,1278,159,190,3127
"655",2020,"Virgin Islands",33,3,0,0,36
"656",2020,"Virginia",36391,21424,9713,0,67528
"657",2020,"Washington",18390,8842,3813,102,31147
"658",2020,"West Virginia",6543,5664,422,864,13493
"659",2020,"Wisconsin",14521,9835,1168,98,25622
"660",2020,"Wyoming",2135,1656,185,214,4190
"661",2019,"Alabama",33020,25882,1560,2764,63226
"662",2019,"Alaska",3455,3080,397,430,7362
"663",2019,"Arizona",18178,10423,1560,2218,32379
"664",2019,"Arkansas",8671,10957,531,916,21075
"665",2019,"California",40637,30780,4883,0,76300
"666",2019,"Colorado",22531,16681,1762,2666,43640
"667",2019,"Connecticut",5655,2215,706,0,8576
"668",2019,"Delaware",2075,2301,120,188,4684
"669",2019,"District of Columbia",101,1,0,2,104
"670",2019,"Florida",67435,31580,4458,6300,109773
"671",2019,"Georgia",21514,17664,880,1614,41672
"672",2019,"Guam",180,86,18,20,304
"673",2019,"Hawaii",0,0,0,0,0
"674",2019,"Idaho",6745,7111,514,656,15026
"675",2019,"Illinois",24792,13258,0,2214,40264
"676",2019,"Indiana",26770,18746,2075,2478,50069
"677",2019,"Iowa",271,4421,81,6,4779
"678",2019,"Kansas",8092,8653,716,952,18413
"679",2019,"Kentucky",16185,14471,729,1506,32891
"680",2019,"Louisiana",14237,16743,912,1534,33426
"681",2019,"Maine",3651,4119,348,422,8540
"682",2019,"Mariana Islands",8,0,2,0,10
"683",2019,"Maryland",4175,6878,186,68,11307
"684",2019,"Massachusetts",4516,2789,510,392,8207
"685",2019,"Michigan",14303,14075,1008,664,30050
"686",2019,"Minnesota",9835,11241,1023,1028,23127
"687",2019,"Mississippi",12935,14538,536,1186,29195
"688",2019,"Missouri",26084,22222,2346,2642,53294
"689",2019,"Montana",4169,5522,301,498,10490
"690",2019,"Nebraska",173,3205,44,8,3430
"691",2019,"Nevada",6307,3636,385,724,11052
"692",2019,"New Hampshire",5471,3255,322,0,9048
"693",2019,"New Jersey",3747,4341,216,0,8304
"694",2019,"New Mexico",7794,5184,584,842,14404
"695",2019,"New York",8899,16654,1517,448,27518
"696",2019,"North Carolina",2559,22945,1295,490,27289
"697",2019,"North Dakota",2155,3171,175,240,5741
"698",2019,"Ohio",31054,23312,2223,2760,59349
"699",2019,"Oklahoma",19110,14320,1574,2446,37450
"700",2019,"Oregon",17610,14016,0,8,31634
"701",2019,"Pennsylvania",53180,20278,32,0,73490
"702",2019,"Puerto Rico",1767,195,131,52,2145
"703",2019,"Rhode Island",1117,794,84,434,2429
"704",2019,"South Carolina",14905,11857,1005,1310,29077
"705",2019,"South Dakota",3264,4482,262,414,8422
"706",2019,"Tennessee",35893,26800,1899,0,64592
"707",2019,"Texas",69732,53386,4713,6796,134627
"708",2019,"Utah",5893,6783,407,0,13083
"709",2019,"Vermont",1610,1613,151,166,3540
"710",2019,"Virgin Islands",32,0,0,0,32
"711",2019,"Virginia",37790,29539,8357,0,75686
"712",2019,"Washington",20508,11752,3724,102,36086
"713",2019,"West Virginia",8815,9944,415,980,20154
"714",2019,"Wisconsin",17195,14486,1223,82,32986
"715",2019,"Wyoming",3293,3077,212,304,6886
"716",2019,"Alabama",24005,19212,1161,2572,46950
"717",2019,"Alaska",3003,2980,368,520,6871
"718",2019,"Arizona",13775,8180,1131,2364,25450
"719",2019,"Arkansas",6814,9628,321,1084,17847
"720",2019,"California",34345,25063,3564,0,62972
"721",2019,"Colorado",17950,13946,1475,2544,35915
"722",2019,"Connecticut",4908,2321,692,0,7921
"723",2019,"Delaware",1684,2063,95,176,4018
"724",2019,"District of Columbia",103,1,0,2,106
"725",2019,"Florida",54799,24497,3666,5848,88810
"726",2019,"Georgia",16171,13002,653,1442,31268
"727",2019,"Guam",98,65,12,10,185
"728",2019,"Hawaii",0,0,0,0,0
"729",2019,"Idaho",4875,5774,426,660,11735
"730",2019,"Illinois",21597,12115,0,2004,35716
"731",2019,"Indiana",21903,17950,1776,2134,43763
"732",2019,"Iowa",348,4487,58,18,4911
"733",2019,"Kansas",7143,7349,606,904,16002
"734",2019,"Kentucky",12094,12686,528,1476,26784
"735",2019,"Louisiana",11282,13282,687,1320,26571
"736",2019,"Maine",2839,4424,292,388,7943
"737",2019,"Mariana Islands",6,6,1,0,13
"738",2019,"Maryland",3447,7153,140,86,10826
"739",2019,"Massachusetts",4651,2868,541,350,8410
"740",2019,"Michigan",13255,19391,747,714,34107
"741",2019,"Minnesota",9148,13550,902,1016,24616
"742",2019,"Mississippi",9210,11603,439,932,22184
"743",2019,"Missouri",21090,21032,1659,2476,46257
"744",2019,"Montana",3032,4517,226,466,8241
"745",2019,"Nebraska",128,2954,21,18,3121
"746",2019,"Nevada",4892,2873,340,636,8741
"747",2019,"New Hampshire",4803,3289,291,4,8387
"748",2019,"New Jersey",3721,3914,200,0,7835
"749",2019,"New Mexico",6317,4586,527,982,12412
"750",2019,"New York",8355,18336,1329,508,28528
"751",2019,"North Carolina",2394,18720,1086,526,22726
"752",2019,"North Dakota",1731,3237,135,210,5313
"753",2019,"Ohio",25230,24933,2034,2780,54977
"754",2019,"Oklahoma",18679,12894,1279,2834,35686
"755",2019,"Oregon",15105,11503,0,18,26626
"756",2019,"Pennsylvania",49972,22212,39,0,72223
"757",2019,"Puerto Rico",1902,203,114,60,2279
"758",2019,"Rhode Island",1039,747,57,348,2191
"759",2019,"South Carolina",11531,9303,822,1490,23146
"760",2019,"South Dakota",2687,4634,205,432,7958
"761",2019,"Tennessee",27826,21101,1706,0,50633
"762",2019,"Texas",57252,41942,3592,7038,109824
"763",2019,"Utah",4095,5038,388,0,9521
"764",2019,"Vermont",1176,1739,106,122,3143
"765",2019,"Virgin Islands",21,2,0,2,25
"766",2019,"Virginia",27949,23374,5338,4,56665
"767",2019,"Washington",13487,10163,2902,98,26650
"768",2019,"West Virginia",5980,9834,299,812,16925
"769",2019,"Wisconsin",15182,18344,1020,130,34676
"770",2019,"Wyoming",2094,2425,169,258,4946
"771",2019,"Alabama",16759,13692,1078,1876,33405
"772",2019,"Alaska",3304,3510,392,604,7810
"773",2019,"Arizona",11543,7509,1138,1596,21786
"774",2019,"Arkansas",4809,7173,351,782,13115
"775",2019,"California",32128,23005,4198,0,59331
"776",2019,"Colorado",15537,13269,1347,2042,32195
"777",2019,"Connecticut",4347,1990,502,0,6839
"778",2019,"Delaware",1624,1749,116,202,3691
"779",2019,"District of Columbia",113,3,0,4,120
"780",2019,"Florida",47504,19816,3830,4988,76138
"781",2019,"Georgia",11105,9858,598,1288,22849
"782",2019,"Guam",125,69,14,16,224
"783",2019,"Hawaii",0,0,0,0,0
"784",2019,"Idaho",3784,5530,375,486,10175
"785",2019,"Illinois",17482,10040,0,1762,29284
"786",2019,"Indiana",16204,12595,1528,1550,31877
"787",2019,"Iowa",174,2940,46,8,3168
"788",2019,"Kansas",4917,5227,480,660,11284
"789",2019,"Kentucky",8759,8890,455,1224,19328
"790",2019,"Louisiana",8450,11231,674,1136,21491
"791",2019,"Maine",2997,5699,294,418,9408
"792",2019,"Mariana Islands",11,4,0,2,17
"793",2019,"Maryland",3372,5731,132,74,9309
"794",2019,"Massachusetts",4064,2561,473,294,7392
"795",2019,"Michigan",9550,12790,685,486,23511
"796",2019,"Minnesota",8762,16263,909,1028,26962
"797",2019,"Mississippi",6506,7086,369,684,14645
"798",2019,"Missouri",16633,18732,1646,2284,39295
"799",2019,"Montana",2612,5541,251,556,8960
"800",2019,"Nebraska",81,2182,21,4,2288
"801",2019,"Nevada",4402,2573,298,514,7787
"802",2019,"New Hampshire",4876,3219,216,2,8313
"803",2019,"New Jersey",3756,3226,229,0,7211
"804",2019,"New Mexico",5518,3964,512,704,10698
"805",2019,"New York",8810,16600,1272,490,27172
"806",2019,"North Carolina",1370,12811,1014,442,15637
"807",2019,"North Dakota",1446,3638,143,210,5437
"808",2019,"Ohio",18896,16127,1706,2248,38977
"809",2019,"Oklahoma",10536,9256,1064,1860,22716
"810",2019,"Oregon",13377,10705,0,12,24094
"811",2019,"Pennsylvania",44371,17094,54,0,61519
"812",2019,"Puerto Rico",1892,161,79,62,2194
"813",2019,"Rhode Island",942,698,66,376,2082
"814",2019,"South Carolina",8542,6648,623,930,16743
"815",2019,"South Dakota",2216,5161,215,410,8002
"816",2019,"Tennessee",21973,15268,1342,0,38583
"817",2019,"Texas",41994,33957,3423,4928,84302
"818",2019,"Utah",2898,3819,312,0,7029
"819",2019,"Vermont",1283,1860,103,166,3412
"820",2019,"Virgin Islands",21,1,0,0,22
"821",2019,"Virginia",20887,15388,3146,4,39425
"822",2019,"Washington",13948,9851,2574,80,26453
"823",2019,"West Virginia",5026,6883,274,760,12943
"824",2019,"Wisconsin",13148,15376,1028,92,29644
"825",2019,"Wyoming",1594,2368,142,206,4310
"826",2019,"Alabama",14259,12550,1100,1602,29511
"827",2019,"Alaska",2276,2766,291,360,5693
"828",2019,"Arizona",12126,7629,1441,1792,22988
"829",2019,"Arkansas",4535,5063,392,672,10662
"830",2019,"California",30776,22726,3524,0,57026
"831",2019,"Colorado",14614,12289,1520,2030,30453
"832",2019,"Connecticut",4115,1726,577,0,6418
"833",2019,"Delaware",1397,1378,134,124,3033
"834",2019,"District of Columbia",94,5,0,4,103
"835",2019,"Florida",44565,18261,4154,4722,71702
"836",2019,"Georgia",10415,7843,601,1066,19925
"837",2019,"Guam",123,58,17,22,220
"838",2019,"Hawaii",0,0,0,0,0
"839",2019,"Idaho",3645,4776,395,458,9274
"840",2019,"Illinois",17639,9512,0,1782,28933
"841",2019,"Indiana",15291,10734,1680,1626,29331
"842",2019,"Iowa",131,2288,31,14,2464
"843",2019,"Kansas",4405,4322,477,528,9732
"844",2019,"Kentucky",8526,6502,489,1054,16571
"845",2019,"Louisiana",8996,9417,786,1264,20463
"846",2019,"Maine",2919,4439,265,422,8045
"847",2019,"Mariana Islands",6,10,0,0,16
"848",2019,"Maryland",2981,4714,131,78,7904
"849",2019,"Massachusetts",3523,2370,468,300,6661
"850",2019,"Michigan",9135,11241,767,478,21621
"851",2019,"Minnesota",8131,14379,870,974,24354
"852",2019,"Mississippi",6384,5653,380,690,13107
"853",2019,"Missouri",15032,13663,1559,2016,32270
"854",2019,"Montana",2651,4533,270,474,7928
"855",2019,"Nebraska",63,1631,23,4,1721
"856",2019,"Nevada",3985,2467,297,534,7283
"857",2019,"New Hampshire",4458,2948,190,0,7596
"858",2019,"New Jersey",3760,3285,218,0,7263
"859",2019,"New Mexico",5517,3752,601,638,10508
"860",2019,"New York",8316,16334,1417,450,26517
"861",2019,"North Carolina",1306,10756,941,422,13425
"862",2019,"North Dakota",1489,3300,134,214,5137
"863",2019,"Ohio",17083,13048,1534,1872,33537
"864",2019,"Oklahoma",8852,7851,1127,1700,19530
"865",2019,"Oregon",12140,10443,0,12,22595
"866",2019,"Pennsylvania",40203,14471,33,0,54707
"867",2019,"Puerto Rico",1554,191,85,58,1888
"868",2019,"Rhode Island",837,649,74,334,1894
"869",2019,"South Carolina",7420,5455,689,656,14220
"870",2019,"South Dakota",2068,3640,168,264,6140
"871",2019,"Tennessee",20638,13292,1314,0,35244
"872",2019,"Texas",42688,35840,3736,4954,87218
"873",2019,"Utah",2892,3430,322,0,6644
"874",2019,"Vermont",1175,1559,154,162,3050
"875",2019,"Virgin Islands",26,2,0,0,28
"876",2019,"Virginia",19517,13336,3231,0,36084
"877",2019,"Washington",12977,8424,2581,84,24066
"878",2019,"West Virginia",4581,5149,339,610,10679
"879",2019,"Wisconsin",12339,13865,980,108,27292
"880",2019,"Wyoming",1595,2274,147,218,4234
"881",2019,"Alabama",18831,12672,1379,2046,34928
"882",2019,"Alaska",2593,3137,319,448,6497
"883",2019,"Arizona",14272,8281,1495,2028,26076
"884",2019,"Arkansas",5267,5445,386,814,11912
"885",2019,"California",36607,25247,3837,0,65691
"886",2019,"Colorado",17237,12352,1522,2322,33433
"887",2019,"Connecticut",4806,1785,712,0,7303
"888",2019,"Delaware",1630,1383,133,156,3302
"889",2019,"District of Columbia",101,5,0,2,108
"890",2019,"Florida",54215,18910,4711,5264,83100
"891",2019,"Georgia",12501,8234,711,1178,22624
"892",2019,"Guam",128,95,18,14,255
"893",2019,"Hawaii",0,0,0,0,0
"894",2019,"Idaho",4039,4604,403,504,9550
"895",2019,"Illinois",19105,9281,0,1580,29966
"896",2019,"Indiana",19883,11389,1756,1708,34736
"897",2019,"Iowa",144,1985,32,10,2171
"898",2019,"Kansas",5240,4730,509,714,11193
"899",2019,"Kentucky",10802,6592,475,1184,19053
"900",2019,"Louisiana",10016,8147,892,1274,20329
"901",2019,"Maine",3054,3398,307,408,7167
"902",2019,"Mariana Islands",4,4,0,2,10
"903",2019,"Maryland",3518,4472,126,70,8186
"904",2019,"Massachusetts",4788,2609,461,456,8314
"905",2019,"Michigan",9724,8698,706,440,19568
"906",2019,"Minnesota",8510,11265,914,952,21641
"907",2019,"Mississippi",9042,7144,492,1102,17780
"908",2019,"Missouri",18605,14755,1809,2272,37441
"909",2019,"Montana",2945,3956,270,502,7673
"910",2019,"Nebraska",91,1600,25,4,1720
"911",2019,"Nevada",4896,2596,385,570,8447
"912",2019,"New Hampshire",5168,2744,225,0,8137
"913",2019,"New Jersey",4061,3341,196,0,7598
"914",2019,"New Mexico",6932,4000,597,748,12277
"915",2019,"New York",7995,11563,1224,480,21262
"916",2019,"North Carolina",1724,11474,1225,476,14899
"917",2019,"North Dakota",1656,2792,154,206,4808
"918",2019,"Ohio",22222,12658,1901,2012,38793
"919",2019,"Oklahoma",10823,8668,1266,1904,22661
"920",2019,"Oregon",13926,9496,0,28,23450
"921",2019,"Pennsylvania",43559,13314,45,0,56918
"922",2019,"Puerto Rico",2135,233,67,46,2481
"923",2019,"Rhode Island",954,618,80,316,1968
"924",2019,"South Carolina",9423,6241,833,910,17407
"925",2019,"South Dakota",2367,3343,195,248,6153
"926",2019,"Tennessee",25754,14536,1540,0,41830
"927",2019,"Texas",49804,36943,3855,5304,95906
"928",2019,"Utah",2976,3002,340,0,6318
"929",2019,"Vermont",1371,1320,156,136,2983
"930",2019,"Virgin Islands",21,3,0,0,24
"931",2019,"Virginia",23429,13458,3324,0,40211
"932",2019,"Washington",13689,7551,2632,94,23966
"933",2019,"West Virginia",5846,4737,339,742,11664
"934",2019,"Wisconsin",13127,11622,1009,128,25886
"935",2019,"Wyoming",1767,2004,166,238,4175
"936",2019,"Alabama",8711,5851,410,706,15678
"937",2019,"Alaska",2172,2139,247,302,4860
"938",2019,"Arizona",11005,5995,1203,1302,19505
"939",2019,"Arkansas",4049,3487,289,610,8435
"940",2019,"California",30400,20830,3485,0,54715
"941",2019,"Colorado",15550,9601,1238,1832,28221
"942",2019,"Connecticut",4235,1403,409,0,6047
"943",2019,"Delaware",1410,936,107,130,2583
"944",2019,"District of Columbia",105,4,0,6,115
"945",2019,"Florida",43914,13570,3307,3936,64727
"946",2019,"Georgia",9663,5261,476,788,16188
"947",2019,"Guam",121,57,14,16,208
"948",2019,"Hawaii",0,0,0,0,0
"949",2019,"Idaho",3504,3341,311,358,7514
"950",2019,"Illinois",15782,6889,0,1460,24131
"951",2019,"Indiana",13982,7568,1225,1166,23941
"952",2019,"Iowa",113,1264,29,8,1414
"953",2019,"Kansas",4255,3203,417,520,8395
"954",2019,"Kentucky",8059,4658,370,902,13989
"955",2019,"Louisiana",7646,5110,624,798,14178
"956",2019,"Maine",2322,2161,190,270,4943
"957",2019,"Mariana Islands",5,8,0,0,13
"958",2019,"Maryland",3082,3162,84,100,6428
"959",2019,"Massachusetts",3711,1886,387,264,6248
"960",2019,"Michigan",7396,5571,538,328,13833
"961",2019,"Minnesota",6938,6575,610,578,14701
"962",2019,"Mississippi",5769,3476,313,604,10162
"963",2019,"Missouri",14131,10224,1249,1574,27178
"964",2019,"Montana",2615,3045,192,418,6270
"965",2019,"Nebraska",80,1047,19,2,1148
"966",2019,"Nevada",3852,1891,313,480,6536
"967",2019,"New Hampshire",3874,1996,217,0,6087
"968",2019,"New Jersey",4160,2590,211,0,6961
"969",2019,"New Mexico",5219,3365,458,758,9800
"970",2019,"New York",7051,8051,1055,428,16585
"971",2019,"North Carolina",1265,7650,806,370,10091
"972",2019,"North Dakota",1219,1942,111,144,3416
"973",2019,"Ohio",15931,9342,1203,1496,27972
"974",2019,"Oklahoma",8752,5997,923,1558,17230
"975",2019,"Oregon",11746,7572,0,12,19330
"976",2019,"Pennsylvania",33850,10017,27,0,43894
"977",2019,"Puerto Rico",1958,192,119,56,2325
"978",2019,"Rhode Island",788,479,73,250,1590
"979",2019,"South Carolina",7274,3667,696,662,12299
"980",2019,"South Dakota",2057,2214,159,212,4642
"981",2019,"Tennessee",19494,10191,1116,0,30801
"982",2019,"Texas",34215,21520,3002,3774,62511
"983",2019,"Utah",2558,2495,269,0,5322
"984",2019,"Vermont",1005,978,122,124,2229
"985",2019,"Virgin Islands",45,5,0,0,50
"986",2019,"Virginia",19139,9731,2757,0,31627
"987",2019,"Washington",12636,5788,2716,78,21218
"988",2019,"West Virginia",4289,3610,229,584,8712
"989",2019,"Wisconsin",9938,6714,746,96,17494
"990",2019,"Wyoming",1528,1587,136,202,3453
"991",2019,"Alabama",6947,4521,298,864,12630
"992",2019,"Alaska",2465,2000,239,364,5068
"993",2019,"Arizona",11375,5931,1309,1312,19927
"994",2019,"Arkansas",4653,3214,292,916,9075
"995",2019,"California",38712,27050,4856,0,70618
"996",2019,"Colorado",16013,10215,1360,1826,29414
"997",2019,"Connecticut",4296,1449,533,0,6278
"998",2019,"Delaware",1364,907,122,90,2483
"999",2019,"District of Columbia",113,3,0,4,120
"1000",2019,"Florida",44378,13576,3642,4968,66564
"1001",2019,"Georgia",10549,5425,566,1560,18100
"1002",2019,"Guam",123,46,8,8,185
"1003",2019,"Hawaii",0,0,0,0,0
"1004",2019,"Idaho",3599,3611,367,392,7969
"1005",2019,"Illinois",17041,7321,0,1530,25892
"1006",2019,"Indiana",15272,7963,1368,1410,26013
"1007",2019,"Iowa",117,1299,20,8,1444
"1008",2019,"Kansas",4133,2981,453,724,8291
"1009",2019,"Kentucky",8520,4608,384,1028,14540
"1010",2019,"Louisiana",7874,4613,673,1624,14784
"1011",2019,"Maine",2616,2091,236,312,5255
"1012",2019,"Mariana Islands",8,9,1,0,18
"1013",2019,"Maryland",3097,3377,98,68,6640
"1014",2019,"Massachusetts",4203,1808,406,276,6693
"1015",2019,"Michigan",8445,5628,589,326,14988
"1016",2019,"Minnesota",7316,6337,747,670,15070
"1017",2019,"Mississippi",5883,3303,286,958,10430
"1018",2019,"Missouri",14970,10263,1443,2210,28886
"1019",2019,"Montana",2644,3130,216,398,6388
"1020",2019,"Nebraska",109,1089,16,2,1216
"1021",2019,"Nevada",4117,2066,306,528,7017
"1022",2019,"New Hampshire",4138,2310,169,2,6619
"1023",2019,"New Jersey",4273,2652,178,0,7103
"1024",2019,"New Mexico",5389,3203,530,510,9632
"1025",2019,"New York",7400,9047,1092,382,17921
"1026",2019,"North Carolina",1411,7908,894,370,10583
"1027",2019,"North Dakota",1286,1942,114,204,3546
"1028",2019,"Ohio",17949,9885,1659,1748,31241
"1029",2019,"Oklahoma",9630,5819,1026,2144,18619
"1030",2019,"Oregon",12046,8124,0,12,20182
"1031",2019,"Pennsylvania",36023,10325,27,0,46375
"1032",2019,"Puerto Rico",2568,193,117,80,2958
"1033",2019,"Rhode Island",787,499,76,258,1620
"1034",2019,"South Carolina",8236,3834,740,1304,14114
"1035",2019,"South Dakota",2162,2237,166,312,4877
"1036",2019,"Tennessee",20708,9777,1510,0,31995
"1037",2019,"Texas",37592,22608,3351,8670,72221
"1038",2019,"Utah",2803,2571,273,0,5647
"1039",2019,"Vermont",1116,982,101,122,2321
"1040",2019,"Virgin Islands",38,7,0,4,49
"1041",2019,"Virginia",20006,9518,2825,0,32349
"1042",2019,"Washington",28670,18920,12059,6202,65851
"1043",2019,"West Virginia",4894,3738,302,526,9460
"1044",2019,"Wisconsin",11174,7388,854,92,19508
"1045",2019,"Wyoming",1664,1728,160,228,3780
"1046",2019,"Alabama",6448,4041,271,684,11444
"1047",2019,"Alaska",2716,2440,287,398,5841
"1048",2019,"Arizona",11969,5987,1242,1448,20646
"1049",2019,"Arkansas",4600,3499,293,842,9234
"1050",2019,"California",36314,24718,4700,0,65732
"1051",2019,"Colorado",16653,10619,1445,2046,30763
"1052",2019,"Connecticut",4655,1622,654,0,6931
"1053",2019,"Delaware",1568,1028,159,180,2935
"1054",2019,"District of Columbia",142,4,0,8,154
"1055",2019,"Florida",45087,14214,3760,4844,67905
"1056",2019,"Georgia",10988,5172,558,1348,18066
"1057",2019,"Guam",102,46,11,6,165
"1058",2019,"Hawaii",0,0,0,0,0
"1059",2019,"Idaho",3738,3728,359,486,8311
"1060",2019,"Illinois",17976,7587,0,1452,27015
"1061",2019,"Indiana",15062,8146,1431,1238,25877
"1062",2019,"Iowa",115,1471,27,2,1615
"1063",2019,"Kansas",4466,3391,462,814,9133
"1064",2019,"Kentucky",7899,4585,343,1022,13849
"1065",2019,"Louisiana",8327,5074,724,1536,15661
"1066",2019,"Maine",2886,2285,331,384,5886
"1067",2019,"Mariana Islands",7,7,2,2,18
"1068",2019,"Maryland",3385,3645,89,50,7169
"1069",2019,"Massachusetts",3759,2113,437,364,6673
"1070",2019,"Michigan",9057,5984,602,392,16035
"1071",2019,"Minnesota",8570,7754,809,756,17889
"1072",2019,"Mississippi",6614,3553,353,990,11510
"1073",2019,"Missouri",15869,10448,1452,2096,29865
"1074",2019,"Montana",2747,3255,222,406,6630
"1075",2019,"Nebraska",67,1089,22,8,1186
"1076",2019,"Nevada",4128,2161,281,508,7078
"1077",2019,"New Hampshire",4079,2328,205,2,6614
"1078",2019,"New Jersey",4791,2545,219,0,7555
"1079",2019,"New Mexico",5564,3361,530,584,10039
"1080",2019,"New York",8260,10090,1296,412,20058
"1081",2019,"North Carolina",1312,7798,989,360,10459
"1082",2019,"North Dakota",1436,2033,106,150,3725
"1083",2019,"Ohio",17577,9758,1569,1728,30632
"1084",2019,"Oklahoma",9704,6112,1055,2016,18887
"1085",2019,"Oregon",12305,8465,0,20,20790
"1086",2019,"Pennsylvania",38050,10807,13,0,48870
"1087",2019,"Puerto Rico",2266,188,153,46,2653
"1088",2019,"Rhode Island",941,515,96,338,1890
"1089",2019,"South Carolina",8332,3531,843,1262,13968
"1090",2019,"South Dakota",2148,2383,187,236,4954
"1091",2019,"Tennessee",20921,9885,1522,0,32328
"1092",2019,"Texas",38714,23587,3118,7986,73405
"1093",2019,"Utah",3045,2849,289,0,6183
"1094",2019,"Vermont",1333,1138,111,122,2704
"1095",2019,"Virgin Islands",27,4,0,0,31
"1096",2019,"Virginia",17935,8821,2454,0,29210
"1097",2019,"Washington",18141,11217,4250,2404,36012
"1098",2019,"West Virginia",4787,3700,278,626,9391
"1099",2019,"Wisconsin",11997,8512,948,112,21569
"1100",2019,"Wyoming",1740,1828,150,216,3934
"1101",2019,"Alabama",6747,4538,265,480,12030
"1102",2019,"Alaska",2704,2605,323,430,6062
"1103",2019,"Arizona",12985,6750,1280,1462,22477
"1104",2019,"Arkansas",4951,4060,319,606,9936
"1105",2019,"California",37484,25895,4204,0,67583
"1106",2019,"Colorado",17199,11594,1470,2282,32545
"1107",2019,"Connecticut",4775,1792,500,0,7067
"1108",2019,"Delaware",1687,1146,132,232,3197
"1109",2019,"District of Columbia",122,1,0,4,127
"1110",2019,"Florida",48329,15125,3652,4260,71366
"1111",2019,"Georgia",12049,5798,608,876,19331
"1112",2019,"Guam",88,46,11,10,155
"1113",2019,"Hawaii",0,0,0,0,0
"1114",2019,"Idaho",3865,4118,379,476,8838
"1115",2019,"Illinois",21307,8748,0,1580,31635
"1116",2019,"Indiana",18528,9718,1493,1372,31111
"1117",2019,"Iowa",200,1761,41,8,2010
"1118",2019,"Kansas",4737,3858,433,592,9620
"1119",2019,"Kentucky",10133,5989,390,904,17416
"1120",2019,"Louisiana",9196,5330,709,864,16099
"1121",2019,"Maine",3134,2819,327,338,6618
"1122",2019,"Mariana Islands",6,6,0,6,18
"1123",2019,"Maryland",3759,4478,120,70,8427
"1124",2019,"Massachusetts",3846,2280,455,350,6931
"1125",2019,"Michigan",10368,7277,798,458,18901
"1126",2019,"Minnesota",10655,11570,1007,1618,24850
"1127",2019,"Mississippi",7199,3936,341,610,12086
"1128",2019,"Missouri",15972,12020,1478,1886,31356
"1129",2019,"Montana",2815,3704,242,532,7293
"1130",2019,"Nebraska",84,1318,20,10,1432
"1131",2019,"Nevada",4502,2535,315,516,7868
"1132",2019,"New Hampshire",4747,2873,207,6,7833
"1133",2019,"New Jersey",4819,2982,213,0,8014
"1134",2019,"New Mexico",5808,3936,609,646,10999
"1135",2019,"New York",8971,12724,1521,460,23676
"1136",2019,"North Carolina",1487,8892,980,368,11727
"1137",2019,"North Dakota",1743,2524,131,198,4596
"1138",2019,"Ohio",22541,11994,2104,1926,38565
"1139",2019,"Oklahoma",10608,7199,1334,1776,20917
"1140",2019,"Oregon",13360,9875,0,22,23257
"1141",2019,"Pennsylvania",42418,12300,32,0,54750
"1142",2019,"Puerto Rico",2135,162,91,34,2422
"1143",2019,"Rhode Island",995,742,115,410,2262
"1144",2019,"South Carolina",9362,4050,702,738,14852
"1145",2019,"South Dakota",2360,2870,193,344,5767
"1146",2019,"Tennessee",21848,10619,1224,0,33691
"1147",2019,"Texas",38994,24009,3451,4334,70788
"1148",2019,"Utah",3365,3235,361,0,6961
"1149",2019,"Vermont",1518,1485,122,182,3307
"1150",2019,"Virgin Islands",24,5,1,4,34
"1151",2019,"Virginia",20270,10699,2692,0,33661
"1152",2019,"Washington",17631,10844,3139,1746,33360
"1153",2019,"West Virginia",5819,4822,318,620,11579
"1154",2019,"Wisconsin",14617,12535,1127,104,28383
"1155",2019,"Wyoming",1888,1906,153,272,4219
"1156",2019,"Alabama",9991,6439,348,720,17498
"1157",2019,"Alaska",3117,2844,355,466,6782
"1158",2019,"Arizona",15993,8497,1422,1894,27806
"1159",2019,"Arkansas",7948,5821,467,830,15066
"1160",2019,"California",42551,28146,4299,0,74996
"1161",2019,"Colorado",22511,13791,1720,2742,40764
"1162",2019,"Connecticut",6189,2344,789,0,9322
"1163",2019,"Delaware",2407,1377,170,216,4170
"1164",2019,"District of Columbia",112,5,0,0,117
"1165",2019,"Florida",59615,19429,3869,5052,87965
"1166",2019,"Georgia",19228,9131,784,1426,30569
"1167",2019,"Guam",123,53,13,12,201
"1168",2019,"Hawaii",0,0,0,0,0
"1169",2019,"Idaho",5362,5161,502,668,11693
"1170",2019,"Illinois",29438,13143,0,2604,45185
"1171",2019,"Indiana",26630,13737,2005,1970,44342
"1172",2019,"Iowa",204,3014,55,10,3283
"1173",2019,"Kansas",7807,5590,693,830,14920
"1174",2019,"Kentucky",15646,8110,534,1562,25852
"1175",2019,"Louisiana",13050,7148,892,1166,22256
"1176",2019,"Maine",4191,2992,380,420,7983
"1177",2019,"Mariana Islands",8,8,2,0,18
"1178",2019,"Maryland",4288,6080,138,84,10590
"1179",2019,"Massachusetts",5079,3151,644,438,9312
"1180",2019,"Michigan",15403,10260,903,572,27138
"1181",2019,"Minnesota",12098,11981,1307,1076,26462
"1182",2019,"Mississippi",11180,6116,430,920,18646
"1183",2019,"Missouri",23939,17749,2160,2898,46746
"1184",2019,"Montana",3703,4218,351,620,8892
"1185",2019,"Nebraska",146,1913,27,10,2096
"1186",2019,"Nevada",6661,3114,446,786,11007
"1187",2019,"New Hampshire",6297,3374,254,0,9925
"1188",2019,"New Jersey",4579,3446,226,0,8251
"1189",2019,"New Mexico",8137,5252,784,1116,15289
"1190",2019,"New York",10834,14996,1751,520,28101
"1191",2019,"North Carolina",1931,12758,1249,580,16518
"1192",2019,"North Dakota",2191,2783,158,212,5344
"1193",2019,"Ohio",31090,17313,2208,2716,53327
"1194",2019,"Oklahoma",15423,9896,1416,2334,29069
"1195",2019,"Oregon",17208,12161,0,14,29383
"1196",2019,"Pennsylvania",60068,16921,29,0,77018
"1197",2019,"Puerto Rico",2238,157,98,62,2555
"1198",2019,"Rhode Island",1201,858,159,536,2754
"1199",2019,"South Carolina",13957,6268,843,1642,22710
"1200",2019,"South Dakota",3274,3450,228,430,7382
"1201",2019,"Tennessee",30728,15086,1463,0,47277
"1202",2019,"Texas",55222,31747,4092,5876,96937
"1203",2019,"Utah",4876,4081,393,0,9350
"1204",2019,"Vermont",2043,1693,220,164,4120
"1205",2019,"Virgin Islands",28,3,0,0,31
"1206",2019,"Virginia",29043,14550,3547,0,47140
"1207",2019,"Washington",21158,13211,3329,1996,39694
"1208",2019,"West Virginia",8633,6778,469,1076,16956
"1209",2019,"Wisconsin",19952,15240,1283,108,36583
"1210",2019,"Wyoming",2497,2314,199,276,5286
"1211",2019,"Alabama",8278,5353,302,902,14835
"1212",2019,"Alaska",2261,1904,276,352,4793
"1213",2019,"Arizona",13933,7135,1244,1956,24268
"1214",2019,"Arkansas",7144,5251,357,1152,13904
"1215",2019,"California",36424,22506,3932,0,62862
"1216",2019,"Colorado",18697,11731,1550,2336,34314
"1217",2019,"Connecticut",5459,1818,654,0,7931
"1218",2019,"Delaware",1698,1208,124,152,3182
"1219",2019,"District of Columbia",88,4,0,0,92
"1220",2019,"Florida",51711,17833,3649,4630,77823
"1221",2019,"Georgia",16172,7742,680,1468,26062
"1222",2019,"Guam",113,51,10,8,182
"1223",2019,"Hawaii",0,0,0,0,0
"1224",2019,"Idaho",3887,3548,394,584,8413
"1225",2019,"Illinois",24870,11381,0,2188,38439
"1226",2019,"Indiana",21297,11157,1623,1708,35785
"1227",2019,"Iowa",153,1935,60,12,2160
"1228",2019,"Kansas",6271,4688,593,934,12486
"1229",2019,"Kentucky",12027,7182,443,1864,21516
"1230",2019,"Louisiana",11056,6849,727,1274,19906
"1231",2019,"Maine",2989,2352,308,326,5975
"1232",2019,"Mariana Islands",10,7,1,2,20
"1233",2019,"Maryland",3822,4613,124,124,8683
"1234",2019,"Massachusetts",4359,2428,555,354,7696
"1235",2019,"Michigan",11272,7497,702,482,19953
"1236",2019,"Minnesota",7938,7215,889,698,16740
"1237",2019,"Mississippi",9790,5717,393,976,16876
"1238",2019,"Missouri",19884,13773,1688,2616,37961
"1239",2019,"Montana",2391,2730,254,674,6049
"1240",2019,"Nebraska",122,1428,26,4,1580
"1241",2019,"Nevada",5541,2524,353,586,9004
"1242",2019,"New Hampshire",5793,2713,230,0,8736
"1243",2019,"New Jersey",3794,2949,174,0,6917
"1244",2019,"New Mexico",6890,4371,673,1240,13174
"1245",2019,"New York",8914,11566,1726,398,22604
"1246",2019,"North Carolina",1620,11335,1083,620,14658
"1247",2019,"North Dakota",1514,1981,131,160,3786
"1248",2019,"Ohio",25652,13985,1635,2246,43518
"1249",2019,"Oklahoma",13014,8165,1318,2252,24749
"1250",2019,"Oregon",14214,9428,0,20,23662
"1251",2019,"Pennsylvania",47570,13297,17,0,60884
"1252",2019,"Puerto Rico",2129,154,83,56,2422
"1253",2019,"Rhode Island",1043,624,134,396,2197
"1254",2019,"South Carolina",12375,5724,760,1666,20525
"1255",2019,"South Dakota",2701,2790,243,374,6108
"1256",2019,"Tennessee",27213,14058,1500,0,42771
"1257",2019,"Texas",49130,28709,3663,6298,87800
"1258",2019,"Utah",3463,3018,317,0,6798
"1259",2019,"Vermont",1545,1373,163,142,3223
"1260",2019,"Virgin Islands",46,1,1,0,48
"1261",2019,"Virginia",24579,12572,3168,0,40319
"1262",2019,"Washington",15775,10106,2927,1820,30628
"1263",2019,"West Virginia",7011,5575,384,1354,14324
"1264",2019,"Wisconsin",13838,9899,1017,124,24878
"1265",2019,"Wyoming",1900,1791,168,236,4095
"1266",2019,"Alabama",6671,5507,343,520,13041
"1267",2019,"Alaska",1877,1685,290,278,4130
"1268",2019,"Arizona",11710,6865,1255,1350,21180
"1269",2019,"Arkansas",5108,5175,401,670,11354
"1270",2019,"California",35861,23195,4035,0,63091
"1271",2019,"Colorado",16417,11575,1796,1992,31780
"1272",2019,"Connecticut",5368,1945,788,0,8101
"1273",2019,"Delaware",1684,1473,141,140,3438
"1274",2019,"District of Columbia",101,5,0,2,108
"1275",2019,"Florida",47372,18749,3651,4264,74036
"1276",2019,"Georgia",11780,7535,670,924,20909
"1277",2019,"Guam",122,42,11,12,187
"1278",2019,"Hawaii",0,0,0,0,0
"1279",2019,"Idaho",3522,3602,414,352,7890
"1280",2019,"Illinois",21587,10082,0,1754,33423
"1281",2019,"Indiana",17265,10423,1738,1362,30788
"1282",2019,"Iowa",128,1887,68,0,2083
"1283",2019,"Kansas",5269,4584,688,588,11129
"1284",2019,"Kentucky",8170,6213,510,900,15793
"1285",2019,"Louisiana",8961,7473,844,920,18198
"1286",2019,"Maine",2652,2333,407,330,5722
"1287",2019,"Mariana Islands",9,11,4,2,26
"1288",2019,"Maryland",4254,4473,100,54,8881
"1289",2019,"Massachusetts",4016,2644,574,396,7630
"1290",2019,"Michigan",8674,6844,800,350,16668
"1291",2019,"Minnesota",8031,7106,1078,690,16905
"1292",2019,"Mississippi",6833,5707,371,610,13521
"1293",2019,"Missouri",16244,12657,1805,1736,32442
"1294",2019,"Montana",2097,2753,278,402,5530
"1295",2019,"Nebraska",125,1711,32,6,1874
"1296",2019,"Nevada",5001,2386,407,514,8308
"1297",2019,"New Hampshire",4672,2529,118,2,7321
"1298",2019,"New Jersey",3508,3084,170,0,6762
"1299",2019,"New Mexico",4987,3778,657,578,10000
"1300",2019,"New York",9271,11257,1804,460,22792
"1301",2019,"North Carolina",1409,10951,1148,402,13910
"1302",2019,"North Dakota",1425,2015,147,204,3791
"1303",2019,"Ohio",19573,12290,1648,1656,35167
"1304",2019,"Oklahoma",10411,8202,1419,1626,21658
"1305",2019,"Oregon",13630,9117,0,22,22769
"1306",2019,"Pennsylvania",40144,11833,7,0,51984
"1307",2019,"Puerto Rico",2030,156,111,84,2381
"1308",2019,"Rhode Island",1054,662,96,334,2146
"1309",2019,"South Carolina",9696,5459,824,680,16659
"1310",2019,"South Dakota",2154,2808,222,254,5438
"1311",2019,"Tennessee",22848,13776,1315,0,37939
"1312",2019,"Texas",39240,27842,3727,4358,75167
"1313",2019,"Utah",3017,2834,344,0,6195
"1314",2019,"Vermont",1124,1092,133,100,2449
"1315",2019,"Virgin Islands",41,2,0,0,43
"1316",2019,"Virginia",20600,12813,3209,0,36622
"1317",2019,"Washington",17487,10889,3622,1726,33724
"1318",2019,"West Virginia",5355,4964,379,764,11462
"1319",2019,"Wisconsin",12204,9154,1310,86,22754
"1320",2019,"Wyoming",1530,1621,175,198,3524
"1321",2018,"Alabama",11463,13578,464,834,26339
"1322",2018,"Alaska",2956,3278,312,310,6856
"1323",2018,"Arizona",15533,11436,1451,1748,30168
"1324",2018,"Arkansas",8138,11736,369,796,21039
"1325",2018,"California",40445,34180,3808,0,78433
"1326",2018,"Colorado",22627,18734,1874,2686,45921
"1327",2018,"Connecticut",5904,2506,947,0,9357
"1328",2018,"Delaware",1932,2503,169,166,4770
"1329",2018,"District of Columbia",71,4,0,2,77
"1330",2018,"Florida",60210,30598,4131,5168,100107
"1331",2018,"Georgia",19241,18475,842,1618,40176
"1332",2018,"Guam",126,62,13,8,209
"1333",2018,"Hawaii",0,0,0,0,0
"1334",2018,"Idaho",5667,6949,442,556,13614
"1335",2018,"Illinois",26943,15297,0,1962,44202
"1336",2018,"Indiana",24824,18824,2088,1990,47726
"1337",2018,"Iowa",262,4392,70,14,4738
"1338",2018,"Kansas",7418,8702,695,880,17695
"1339",2018,"Kentucky",14189,14309,581,1236,30315
"1340",2018,"Louisiana",13856,17376,910,1542,33684
"1341",2018,"Maine",3783,4282,377,452,8894
"1342",2018,"Mariana Islands",3,7,0,0,10
"1343",2018,"Maryland",4500,7309,102,96,12007
"1344",2018,"Massachusetts",4492,3178,558,312,8540
"1345",2018,"Michigan",12897,13972,901,514,28284
"1346",2018,"Minnesota",9144,11057,1032,860,22093
"1347",2018,"Mississippi",11557,14731,469,1086,27843
"1348",2018,"Missouri",24730,23584,2058,2610,52982
"1349",2018,"Montana",3744,5291,286,472,9793
"1350",2018,"Nebraska",160,3331,33,20,3544
"1351",2018,"Nevada",5889,3993,429,616,10927
"1352",2018,"New Hampshire",5845,3977,175,2,9999
"1353",2018,"New Jersey",3432,4099,128,0,7659
"1354",2018,"New Mexico",6858,6580,695,670,14803
"1355",2018,"New York",9675,19234,1733,498,31140
"1356",2018,"North Carolina",2367,22327,1265,478,26437
"1357",2018,"North Dakota",1853,3144,132,200,5329
"1358",2018,"Ohio",30746,25012,1863,2454,60075
"1359",2018,"Oklahoma",15708,16053,1492,2256,35509
"1360",2018,"Oregon",16985,14374,0,10,31369
"1361",2018,"Pennsylvania",54857,20732,18,0,75607
"1362",2018,"Puerto Rico",2026,215,113,48,2402
"1363",2018,"Rhode Island",1069,770,99,324,2262
"1364",2018,"South Carolina",13465,11856,1084,1050,27455
"1365",2018,"South Dakota",2913,4497,215,376,8001
"1366",2018,"Tennessee",34499,26987,1847,0,63333
"1367",2018,"Texas",62560,56919,4482,6276,130237
"1368",2018,"Utah",5369,7214,477,0,13060
"1369",2018,"Vermont",1620,1871,142,158,3791
"1370",2018,"Virgin Islands",27,4,1,6,38
"1371",2018,"Virginia",26129,22048,3524,0,51701
"1372",2018,"Washington",23131,20690,5796,2684,52301
"1373",2018,"West Virginia",9693,10824,464,1006,21987
"1374",2018,"Wisconsin",16181,14362,1363,108,32014
"1375",2018,"Wyoming",2653,3033,166,288,6140
"1376",2018,"Alabama",8408,10303,357,2306,21374
"1377",2018,"Alaska",2707,2827,360,394,6288
"1378",2018,"Arizona",12412,8886,1139,1758,24195
"1379",2018,"Arkansas",5739,10196,300,1828,18063
"1380",2018,"California",36997,30913,3606,0,71516
"1381",2018,"Colorado",18926,15702,1547,2476,38651
"1382",2018,"Connecticut",5078,2331,863,0,8272
"1383",2018,"Delaware",1578,2082,124,146,3930
"1384",2018,"District of Columbia",80,3,0,0,83
"1385",2018,"Florida",51850,23876,3502,7090,86318
"1386",2018,"Georgia",13770,13749,654,2932,31105
"1387",2018,"Guam",120,49,15,12,196
"1388",2018,"Hawaii",0,0,0,0,0
"1389",2018,"Idaho",4077,5851,422,508,10858
"1390",2018,"Illinois",22978,14038,0,2260,39276
"1391",2018,"Indiana",20522,18723,1533,1992,42770
"1392",2018,"Iowa",303,4319,36,14,4672
"1393",2018,"Kansas",5885,7334,459,1530,15208
"1394",2018,"Kentucky",10506,12670,437,1776,25389
"1395",2018,"Louisiana",10242,14336,788,4556,29922
"1396",2018,"Maine",2661,3768,313,420,7162
"1397",2018,"Mariana Islands",5,7,0,0,12
"1398",2018,"Maryland",3979,7150,137,80,11346
"1399",2018,"Massachusetts",4334,3194,532,356,8416
"1400",2018,"Michigan",11474,17534,596,420,30024
"1401",2018,"Minnesota",6691,10900,704,582,18877
"1402",2018,"Mississippi",7650,11816,379,2704,22549
"1403",2018,"Missouri",19158,21908,1551,4316,46933
"1404",2018,"Montana",2727,4603,274,502,8106
"1405",2018,"Nebraska",198,2964,32,14,3208
"1406",2018,"Nevada",4806,3132,349,540,8827
"1407",2018,"New Hampshire",5051,3514,95,0,8660
"1408",2018,"New Jersey",3297,3769,150,0,7216
"1409",2018,"New Mexico",5731,5331,604,1072,12738
"1410",2018,"New York",8290,18315,1436,456,28497
"1411",2018,"North Carolina",2159,18381,927,576,22043
"1412",2018,"North Dakota",1655,3274,147,230,5306
"1413",2018,"Ohio",25372,26274,1615,2482,55743
"1414",2018,"Oklahoma",12669,14074,1240,3830,31813
"1415",2018,"Oregon",14426,12344,0,10,26780
"1416",2018,"Pennsylvania",49328,20463,24,0,69815
"1417",2018,"Puerto Rico",2611,227,130,60,3028
"1418",2018,"Rhode Island",1020,727,121,332,2200
"1419",2018,"South Carolina",10229,9329,891,1892,22341
"1420",2018,"South Dakota",2637,4907,216,332,8092
"1421",2018,"Tennessee",27015,22267,2998,0,52280
"1422",2018,"Texas",44763,43276,3437,19208,110684
"1423",2018,"Utah",3989,5599,325,0,9913
"1424",2018,"Vermont",1094,1690,120,108,3012
"1425",2018,"Virgin Islands",42,6,0,6,54
"1426",2018,"Virginia",22204,19747,3138,0,45089
"1427",2018,"Washington",20113,19136,5557,2778,47584
"1428",2018,"West Virginia",6450,10648,330,848,18276
"1429",2018,"Wisconsin",14769,17342,939,82,33132
"1430",2018,"Wyoming",1933,2532,144,242,4851
"1431",2018,"Alabama",5218,5918,229,558,11923
"1432",2018,"Alaska",3034,3245,327,572,7178
"1433",2018,"Arizona",9886,6427,980,1188,18481
"1434",2018,"Arkansas",4312,6792,220,694,12018
"1435",2018,"California",32567,23213,2738,0,58518
"1436",2018,"Colorado",15101,13079,1111,1870,31161
"1437",2018,"Connecticut",4575,1979,635,0,7189
"1438",2018,"Delaware",1420,1512,92,196,3220
"1439",2018,"District of Columbia",81,5,0,0,86
"1440",2018,"Florida",40226,16671,2912,4036,63845
"1441",2018,"Georgia",10007,8856,444,1052,20359
"1442",2018,"Guam",120,41,8,20,189
"1443",2018,"Hawaii",0,0,0,0,0
"1444",2018,"Idaho",3034,5025,255,388,8702
"1445",2018,"Illinois",17916,10755,0,1552,30223
"1446",2018,"Indiana",15032,12352,1151,1438,29973
"1447",2018,"Iowa",173,2700,23,2,2898
"1448",2018,"Kansas",4223,4884,428,600,10135
"1449",2018,"Kentucky",7065,8001,360,1046,16472
"1450",2018,"Louisiana",8073,10567,591,1074,20305
"1451",2018,"Maine",2565,5428,251,364,8608
"1452",2018,"Mariana Islands",5,7,1,2,15
"1453",2018,"Maryland",4020,5112,124,58,9314
"1454",2018,"Massachusetts",3750,2632,446,302,7130
"1455",2018,"Michigan",8259,11649,508,342,20758
"1456",2018,"Minnesota",5041,14232,517,700,20490
"1457",2018,"Mississippi",6049,6638,324,700,13711
"1458",2018,"Missouri",15963,17163,1320,2252,36698
"1459",2018,"Montana",2293,5246,189,496,8224
"1460",2018,"Nebraska",119,2172,16,4,2311
"1461",2018,"Nevada",3731,2051,272,400,6454
"1462",2018,"New Hampshire",4238,3494,35,2,7769
"1463",2018,"New Jersey",3710,2806,158,0,6674
"1464",2018,"New Mexico",4655,3993,458,518,9624
"1465",2018,"New York",8258,16163,1010,402,25833
"1466",2018,"North Carolina",1392,12065,724,440,14621
"1467",2018,"North Dakota",1487,3700,113,170,5470
"1468",2018,"Ohio",18401,15830,1139,1992,37362
"1469",2018,"Oklahoma",8849,8803,919,1992,20563
"1470",2018,"Oregon",11776,10088,0,12,21876
"1471",2018,"Pennsylvania",41412,14583,27,0,56022
"1472",2018,"Puerto Rico",2419,193,94,68,2774
"1473",2018,"Rhode Island",947,646,79,326,1998
"1474",2018,"South Carolina",7002,6023,596,704,14325
"1475",2018,"South Dakota",1882,5208,154,290,7534
"1476",2018,"Tennessee",20286,13725,1303,0,35314
"1477",2018,"Texas",34646,31100,2972,4478,73196
"1478",2018,"Utah",2615,3619,269,0,6503
"1479",2018,"Vermont",1100,1948,107,106,3261
"1480",2018,"Virgin Islands",39,3,0,0,42
"1481",2018,"Virginia",17662,13511,2438,0,33611
"1482",2018,"Washington",14925,11932,2387,1550,30794
"1483",2018,"West Virginia",5250,6998,292,760,13300
"1484",2018,"Wisconsin",11766,14833,801,94,27494
"1485",2018,"Wyoming",1442,2172,102,230,3946
"1486",2018,"Alabama",4978,5832,241,542,11593
"1487",2018,"Alaska",2105,2554,225,330,5214
"1488",2018,"Arizona",10298,6638,1096,1308,19340
"1489",2018,"Arkansas",3987,5257,247,640,10131
"1490",2018,"California",29772,23788,2977,0,56537
"1491",2018,"Colorado",14546,12061,1022,1866,29495
"1492",2018,"Connecticut",4151,1782,499,0,6432
"1493",2018,"Delaware",1187,1225,73,106,2591
"1494",2018,"District of Columbia",78,4,0,2,84
"1495",2018,"Florida",38313,14646,2945,3468,59372
"1496",2018,"Georgia",10387,7060,476,910,18833
"1497",2018,"Guam",77,24,11,14,126
"1498",2018,"Hawaii",0,0,0,0,0
"1499",2018,"Idaho",3217,4776,212,422,8627
"1500",2018,"Illinois",16749,9393,0,1438,27580
"1501",2018,"Indiana",13687,10201,1068,1220,26176
"1502",2018,"Iowa",132,2391,33,4,2560
"1503",2018,"Kansas",4043,4326,421,558,9348
"1504",2018,"Kentucky",6603,6014,300,896,13813
"1505",2018,"Louisiana",8654,9546,699,1214,20113
"1506",2018,"Maine",2678,4102,184,376,7340
"1507",2018,"Mariana Islands",4,2,2,0,8
"1508",2018,"Maryland",3413,4397,100,58,7968
"1509",2018,"Massachusetts",3518,2407,393,332,6650
"1510",2018,"Michigan",7630,9887,446,310,18273
"1511",2018,"Minnesota",3801,10997,359,434,15591
"1512",2018,"Mississippi",6470,6042,330,662,13504
"1513",2018,"Missouri",15226,12816,1270,1996,31308
"1514",2018,"Montana",2326,4565,176,552,7619
"1515",2018,"Nebraska",83,1547,17,6,1653
"1516",2018,"Nevada",3714,2111,284,448,6557
"1517",2018,"New Hampshire",4150,3161,163,8,7482
"1518",2018,"New Jersey",3511,2480,147,0,6138
"1519",2018,"New Mexico",4596,3985,437,518,9536
"1520",2018,"New York",7755,15014,1017,368,24154
"1521",2018,"North Carolina",958,8836,700,356,10850
"1522",2018,"North Dakota",1336,3135,100,128,4699
"1523",2018,"Ohio",17460,13312,1110,1736,33618
"1524",2018,"Oklahoma",8158,7776,921,1652,18507
"1525",2018,"Oregon",11763,10604,0,14,22381
"1526",2018,"Pennsylvania",36793,12563,36,0,49392
"1527",2018,"Puerto Rico",2155,197,97,46,2495
"1528",2018,"Rhode Island",738,562,111,320,1731
"1529",2018,"South Carolina",6680,4748,501,576,12505
"1530",2018,"South Dakota",1975,3564,184,292,6015
"1531",2018,"Tennessee",18721,11942,1167,0,31830
"1532",2018,"Texas",33746,33087,2907,4334,74074
"1533",2018,"Utah",2678,3400,274,0,6352
"1534",2018,"Vermont",1486,1853,114,240,3693
"1535",2018,"Virgin Islands",21,1,0,0,22
"1536",2018,"Virginia",16923,12040,2448,0,31411
"1537",2018,"Washington",13517,11021,1953,1150,27641
"1538",2018,"West Virginia",4914,5918,248,648,11728
"1539",2018,"Wisconsin",11254,12707,762,100,24823
"1540",2018,"Wyoming",1545,2235,121,222,4123
"1541",2018,"Alabama",5991,5741,218,548,12498
"1542",2018,"Alaska",2593,3057,220,362,6232
"1543",2018,"Arizona",10833,6987,887,1386,20093
"1544",2018,"Arkansas",4809,5590,226,684,11309
"1545",2018,"California",34617,25666,3117,0,63400
"1546",2018,"Colorado",16160,12392,1062,1942,31556
"1547",2018,"Connecticut",4519,1690,605,0,6814
"1548",2018,"Delaware",1262,1162,85,116,2625
"1549",2018,"District of Columbia",91,1,0,4,96
"1550",2018,"Florida",44227,15734,3176,3870,67007
"1551",2018,"Georgia",10894,7419,431,972,19716
"1552",2018,"Guam",84,37,9,6,136
"1553",2018,"Hawaii",0,0,0,0,0
"1554",2018,"Idaho",3374,3899,254,370,7897
"1555",2018,"Illinois",17992,9858,0,1330,29180
"1556",2018,"Indiana",15764,10339,1252,1396,28751
"1557",2018,"Iowa",160,1935,18,12,2125
"1558",2018,"Kansas",4500,4505,365,598,9968
"1559",2018,"Kentucky",7250,6241,306,980,14777
"1560",2018,"Louisiana",9103,8745,693,1238,19779
"1561",2018,"Maine",2835,2946,236,276,6293
"1562",2018,"Mariana Islands",6,7,0,0,13
"1563",2018,"Maryland",4148,4001,103,68,8320
"1564",2018,"Massachusetts",4322,2396,428,442,7588
"1565",2018,"Michigan",8110,7973,440,312,16835
"1566",2018,"Minnesota",3773,8142,312,378,12605
"1567",2018,"Mississippi",7489,6695,320,788,15292
"1568",2018,"Missouri",16706,13657,1371,2008,33742
"1569",2018,"Montana",2617,3805,162,436,7020
"1570",2018,"Nebraska",95,1493,16,14,1618
"1571",2018,"Nevada",4164,2137,271,396,6968
"1572",2018,"New Hampshire",4382,2960,139,2,7483
"1573",2018,"New Jersey",4069,2968,179,0,7216
"1574",2018,"New Mexico",5303,4077,421,586,10387
"1575",2018,"New York",8314,11362,970,386,21032
"1576",2018,"North Carolina",1180,10190,738,434,12542
"1577",2018,"North Dakota",1284,2475,102,158,4019
"1578",2018,"Ohio",18482,12449,1181,1788,33900
"1579",2018,"Oklahoma",9823,8558,981,1698,21060
"1580",2018,"Oregon",11938,8751,0,20,20709
"1581",2018,"Pennsylvania",38142,11911,48,0,50101
"1582",2018,"Puerto Rico",2414,247,90,84,2835
"1583",2018,"Rhode Island",911,589,66,248,1814
"1584",2018,"South Carolina",8135,5763,513,750,15161
"1585",2018,"South Dakota",2012,3041,155,278,5486
"1586",2018,"Tennessee",20996,13165,1112,0,35273
"1587",2018,"Texas",37819,35212,2934,4646,80611
"1588",2018,"Utah",2650,2996,254,0,5900
"1589",2018,"Vermont",1336,1251,99,150,2836
"1590",2018,"Virgin Islands",27,2,1,4,34
"1591",2018,"Virginia",18729,11694,2329,0,32752
"1592",2018,"Washington",14615,9761,1874,1104,27354
"1593",2018,"West Virginia",4986,4987,265,750,10988
"1594",2018,"Wisconsin",11118,10987,697,82,22884
"1595",2018,"Wyoming",1570,2059,87,198,3914
"1596",2018,"Alabama",5110,4540,222,444,10316
"1597",2018,"Alaska",2391,2195,180,364,5130
"1598",2018,"Arizona",10166,5848,1020,1236,18270
"1599",2018,"Arkansas",4245,3625,237,578,8685
"1600",2018,"California",30486,21136,3054,0,54676
"1601",2018,"Colorado",15420,10239,1106,1802,28567
"1602",2018,"Connecticut",4379,1611,445,0,6435
"1603",2018,"Delaware",1314,950,103,126,2493
"1604",2018,"District of Columbia",88,2,0,0,90
"1605",2018,"Florida",42524,13468,3215,3702,62909
"1606",2018,"Georgia",9759,5232,469,858,16318
"1607",2018,"Guam",93,43,6,6,148
"1608",2018,"Hawaii",0,0,0,0,0
"1609",2018,"Idaho",3202,3160,247,330,6939
"1610",2018,"Illinois",16840,7743,0,1356,25939
"1611",2018,"Indiana",13914,7825,1101,1134,23974
"1612",2018,"Iowa",76,1469,31,8,1584
"1613",2018,"Kansas",4579,3410,444,508,8941
"1614",2018,"Kentucky",6306,4537,295,682,11820
"1615",2018,"Louisiana",8596,6115,665,1026,16402
"1616",2018,"Maine",2542,2294,222,286,5344
"1617",2018,"Mariana Islands",5,7,3,0,15
"1618",2018,"Maryland",3730,3398,115,72,7315
"1619",2018,"Massachusetts",3380,1997,383,252,6012
"1620",2018,"Michigan",7846,6018,457,292,14613
"1621",2018,"Minnesota",3275,5135,310,320,9040
"1622",2018,"Mississippi",5884,3568,291,562,10305
"1623",2018,"Missouri",14330,10470,1187,1568,27555
"1624",2018,"Montana",2421,2865,192,410,5888
"1625",2018,"Nebraska",91,1090,16,2,1199
"1626",2018,"Nevada",3678,1799,279,412,6168
"1627",2018,"New Hampshire",4157,2332,147,2,6638
"1628",2018,"New Jersey",4193,2486,178,0,6857
"1629",2018,"New Mexico",4795,3252,423,706,9176
"1630",2018,"New York",7901,8692,916,326,17835
"1631",2018,"North Carolina",1145,7771,716,330,9962
"1632",2018,"North Dakota",1079,1791,99,98,3067
"1633",2018,"Ohio",16942,10255,1102,1556,29855
"1634",2018,"Oklahoma",8920,6314,903,1526,17663
"1635",2018,"Oregon",10543,7700,0,4,18247
"1636",2018,"Pennsylvania",33494,9738,29,0,43261
"1637",2018,"Puerto Rico",1968,139,110,70,2287
"1638",2018,"Rhode Island",799,453,67,218,1537
"1639",2018,"South Carolina",6972,4037,592,528,12129
"1640",2018,"South Dakota",1678,2160,165,182,4185
"1641",2018,"Tennessee",19188,9840,1071,0,30099
"1642",2018,"Texas",35363,23141,2882,4002,65388
"1643",2018,"Utah",2603,2497,246,0,5346
"1644",2018,"Vermont",1156,999,97,90,2342
"1645",2018,"Virgin Islands",37,2,1,2,42
"1646",2018,"Virginia",18547,10039,2474,0,31060
"1647",2018,"Washington",13547,8385,1695,1144,24771
"1648",2018,"West Virginia",4473,3951,242,586,9252
"1649",2018,"Wisconsin",9351,7471,693,72,17587
"1650",2018,"Wyoming",1448,1559,90,168,3265
"1651",2018,"Alabama",5868,4646,284,1028,11826
"1652",2018,"Alaska",2788,2324,224,382,5718
"1653",2018,"Arizona",10785,5965,1096,1168,19014
"1654",2018,"Arkansas",4478,3528,297,1022,9325
"1655",2018,"California",32684,23612,3921,0,60217
"1656",2018,"Colorado",15796,10351,1215,1928,29290
"1657",2018,"Connecticut",4725,1673,368,0,6766
"1658",2018,"Delaware",1412,1019,171,142,2744
"1659",2018,"District of Columbia",79,3,0,0,82
"1660",2018,"Florida",44821,14764,3586,4950,68121
"1661",2018,"Georgia",11269,5571,475,1762,19077
"1662",2018,"Guam",92,38,12,8,150
"1663",2018,"Hawaii",0,0,0,0,0
"1664",2018,"Idaho",3609,3734,301,480,8124
"1665",2018,"Illinois",17755,7827,0,1244,26826
"1666",2018,"Indiana",15459,8455,1214,1328,26456
"1667",2018,"Iowa",92,1415,39,2,1548
"1668",2018,"Kansas",4344,3247,438,868,8897
"1669",2018,"Kentucky",7130,4686,304,1046,13166
"1670",2018,"Louisiana",9703,5683,757,2622,18765
"1671",2018,"Maine",2655,2342,223,326,5546
"1672",2018,"Mariana Islands",9,7,1,0,17
"1673",2018,"Maryland",4095,3608,141,58,7902
"1674",2018,"Massachusetts",3996,2249,398,304,6947
"1675",2018,"Michigan",8369,6096,568,336,15369
"1676",2018,"Minnesota",3603,5075,376,420,9474
"1677",2018,"Mississippi",6446,3594,285,1446,11771
"1678",2018,"Missouri",15679,10488,1421,2772,30360
"1679",2018,"Montana",2592,3377,194,380,6543
"1680",2018,"Nebraska",103,1089,17,6,1215
"1681",2018,"Nevada",4117,2112,317,446,6992
"1682",2018,"New Hampshire",4430,2542,147,22,7141
"1683",2018,"New Jersey",4609,2626,178,0,7413
"1684",2018,"New Mexico",5109,3363,471,536,9479
"1685",2018,"New York",8745,9688,1028,410,19871
"1686",2018,"North Carolina",1348,8100,762,398,10608
"1687",2018,"North Dakota",1248,1778,100,114,3240
"1688",2018,"Ohio",17338,10649,1163,1518,30668
"1689",2018,"Oklahoma",10295,6449,971,2620,20335
"1690",2018,"Oregon",12700,8659,0,6,21365
"1691",2018,"Pennsylvania",37280,10817,29,0,48126
"1692",2018,"Puerto Rico",2174,187,109,46,2516
"1693",2018,"Rhode Island",834,582,65,282,1763
"1694",2018,"South Carolina",7950,3967,612,1330,13859
"1695",2018,"South Dakota",1880,2313,151,242,4586
"1696",2018,"Tennessee",20805,10399,1821,0,33025
"1697",2018,"Texas",39032,24252,3160,11494,77938
"1698",2018,"Utah",2941,2704,277,0,5922
"1699",2018,"Vermont",1347,1181,107,148,2783
"1700",2018,"Virgin Islands",46,4,1,0,51
"1701",2018,"Virginia",17812,9865,2376,0,30053
"1702",2018,"Washington",15069,9423,1865,1148,27505
"1703",2018,"West Virginia",4988,4109,275,604,9976
"1704",2018,"Wisconsin",9993,7627,708,94,18422
"1705",2018,"Wyoming",1633,1660,95,160,3548
"1706",2018,"Alabama",5784,5039,253,428,11504
"1707",2018,"Alaska",3363,2879,283,446,6971
"1708",2018,"Arizona",11194,6241,1173,1304,19912
"1709",2018,"Arkansas",4355,3442,254,520,8571
"1710",2018,"California",34433,24797,3995,0,63225
"1711",2018,"Colorado",16113,11143,1282,2000,30538
"1712",2018,"Connecticut",4454,1775,346,0,6575
"1713",2018,"Delaware",1422,1107,175,160,2864
"1714",2018,"District of Columbia",88,2,0,0,90
"1715",2018,"Florida",47755,15850,3723,4172,71500
"1716",2018,"Georgia",11159,5669,496,890,18214
"1717",2018,"Guam",90,46,18,4,158
"1718",2018,"Hawaii",0,0,0,0,0
"1719",2018,"Idaho",3387,3812,302,412,7913
"1720",2018,"Illinois",18631,8397,0,1288,28316
"1721",2018,"Indiana",15856,8256,1296,1296,26704
"1722",2018,"Iowa",95,1507,36,12,1650
"1723",2018,"Kansas",4305,3307,434,504,8550
"1724",2018,"Kentucky",7620,4696,344,868,13528
"1725",2018,"Louisiana",9039,5435,710,988,16172
"1726",2018,"Maine",2978,2362,302,376,6018
"1727",2018,"Mariana Islands",6,6,0,2,14
"1728",2018,"Maryland",4503,3961,132,54,8650
"1729",2018,"Massachusetts",4167,2351,410,362,7290
"1730",2018,"Michigan",8598,6049,620,366,15633
"1731",2018,"Minnesota",4034,5435,445,376,10290
"1732",2018,"Mississippi",6653,3624,315,552,11144
"1733",2018,"Missouri",15576,10536,1334,1540,28986
"1734",2018,"Montana",2557,3578,194,438,6767
"1735",2018,"Nebraska",111,1139,20,14,1284
"1736",2018,"Nevada",4185,2209,321,498,7213
"1737",2018,"New Hampshire",4707,2524,165,20,7416
"1738",2018,"New Jersey",4983,2810,244,0,8037
"1739",2018,"New Mexico",5296,3355,497,536,9684
"1740",2018,"New York",8916,10491,1109,430,20946
"1741",2018,"North Carolina",1322,8298,903,360,10883
"1742",2018,"North Dakota",1327,1829,97,142,3395
"1743",2018,"Ohio",18830,10891,1395,1512,32628
"1744",2018,"Oklahoma",9964,6610,1135,1680,19389
"1745",2018,"Oregon",13221,9111,0,6,22338
"1746",2018,"Pennsylvania",39765,10670,31,0,50466
"1747",2018,"Puerto Rico",2187,230,155,56,2628
"1748",2018,"Rhode Island",977,610,90,328,2005
"1749",2018,"South Carolina",7883,3855,657,828,13223
"1750",2018,"South Dakota",1874,2351,195,244,4664
"1751",2018,"Tennessee",20549,10028,1205,0,31782
"1752",2018,"Texas",37893,24419,3348,4520,70180
"1753",2018,"Utah",3202,3025,317,0,6544
"1754",2018,"Vermont",1322,1241,171,132,2866
"1755",2018,"Virgin Islands",37,4,1,2,44
"1756",2018,"Virginia",18493,9958,2409,0,30860
"1757",2018,"Washington",15131,9417,1884,1272,27704
"1758",2018,"West Virginia",5258,4037,291,610,10196
"1759",2018,"Wisconsin",10738,8239,914,78,19969
"1760",2018,"Wyoming",1734,1813,134,248,3929
"1761",2018,"Alabama",6405,5267,335,508,12515
"1762",2018,"Alaska",3053,3013,318,492,6876
"1763",2018,"Arizona",12889,7176,1435,1272,22772
"1764",2018,"Arkansas",5129,4326,315,570,10340
"1765",2018,"California",37814,25571,3736,0,67121
"1766",2018,"Colorado",19015,13280,1744,2422,36461
"1767",2018,"Connecticut",4977,2151,510,0,7638
"1768",2018,"Delaware",1767,1697,423,250,4137
"1769",2018,"District of Columbia",92,4,1,0,97
"1770",2018,"Florida",50172,18650,4446,4372,77640
"1771",2018,"Georgia",12238,6549,665,954,20406
"1772",2018,"Guam",97,44,10,8,159
"1773",2018,"Hawaii",0,0,0,0,0
"1774",2018,"Idaho",3843,4182,453,418,8896
"1775",2018,"Illinois",23977,10883,0,1784,36644
"1776",2018,"Indiana",19405,11491,1758,1500,34154
"1777",2018,"Iowa",156,2140,58,2,2356
"1778",2018,"Kansas",5457,4530,654,532,11173
"1779",2018,"Kentucky",8893,6662,439,976,16970
"1780",2018,"Louisiana",9937,6304,869,1058,18168
"1781",2018,"Maine",3572,3580,382,412,7946
"1782",2018,"Mariana Islands",12,10,0,0,22
"1783",2018,"Maryland",4867,5181,167,82,10297
"1784",2018,"Massachusetts",4619,2967,525,352,8463
"1785",2018,"Michigan",11288,8635,836,474,21233
"1786",2018,"Minnesota",6258,9688,744,690,17380
"1787",2018,"Mississippi",7561,4186,422,678,12847
"1788",2018,"Missouri",18537,13868,1791,2268,36464
"1789",2018,"Montana",2745,4018,225,460,7448
"1790",2018,"Nebraska",111,1478,27,12,1628
"1791",2018,"Nevada",4424,2689,382,534,8029
"1792",2018,"New Hampshire",5647,3465,211,16,9339
"1793",2018,"New Jersey",5170,3549,239,0,8958
"1794",2018,"New Mexico",5857,4163,578,590,11188
"1795",2018,"New York",10068,14667,1722,484,26941
"1796",2018,"North Carolina",1340,10138,1121,374,12973
"1797",2018,"North Dakota",1824,2622,164,222,4832
"1798",2018,"Ohio",25111,15459,1971,2326,44867
"1799",2018,"Oklahoma",11599,8386,1629,1702,23316
"1800",2018,"Oregon",15089,11283,0,16,26388
"1801",2018,"Pennsylvania",47093,13434,38,0,60565
"1802",2018,"Puerto Rico",1936,178,71,52,2237
"1803",2018,"Rhode Island",1131,773,159,438,2501
"1804",2018,"South Carolina",8977,4681,789,1338,15785
"1805",2018,"South Dakota",2403,2994,256,368,6021
"1806",2018,"Tennessee",23325,12360,1329,0,37014
"1807",2018,"Texas",41373,27019,3930,5016,77338
"1808",2018,"Utah",3667,3460,442,0,7569
"1809",2018,"Vermont",2261,2290,356,320,5227
"1810",2018,"Virgin Islands",55,7,0,2,64
"1811",2018,"Virginia",20638,12759,3022,0,36419
"1812",2018,"Washington",17123,11153,2319,1308,31903
"1813",2018,"West Virginia",6251,5479,365,744,12839
"1814",2018,"Wisconsin",14507,13478,1394,90,29469
"1815",2018,"Wyoming",1846,1929,154,212,4141
"1816",2018,"Alabama",10050,7695,469,836,19050
"1817",2018,"Alaska",3080,3276,458,428,7242
"1818",2018,"Arizona",16991,10611,1984,1846,31432
"1819",2018,"Arkansas",8523,7017,551,1030,17121
"1820",2018,"California",47425,32189,4802,0,84416
"1821",2018,"Colorado",24811,17741,2381,3280,48213
"1822",2018,"Connecticut",6906,2977,665,0,10548
"1823",2018,"Delaware",2385,2282,527,364,5558
"1824",2018,"District of Columbia",93,3,0,2,98
"1825",2018,"Florida",64230,30487,6732,5616,107065
"1826",2018,"Georgia",19849,10901,959,1638,33347
"1827",2018,"Guam",78,50,12,12,152
"1828",2018,"Hawaii",0,0,0,0,0
"1829",2018,"Idaho",5386,5788,611,572,12357
"1830",2018,"Illinois",32326,17008,0,2704,52038
"1831",2018,"Indiana",28224,16982,2950,2332,50488
"1832",2018,"Iowa",177,3585,73,6,3841
"1833",2018,"Kansas",8400,6921,965,940,17226
"1834",2018,"Kentucky",14642,10303,818,1454,27217
"1835",2018,"Louisiana",13831,8906,1336,1494,25567
"1836",2018,"Maine",4640,3947,655,494,9736
"1837",2018,"Mariana Islands",14,7,3,2,26
"1838",2018,"Maryland",6360,7182,206,108,13856
"1839",2018,"Massachusetts",6636,3974,640,432,11682
"1840",2018,"Michigan",17166,12721,1305,664,31856
"1841",2018,"Minnesota",7583,11538,1040,746,20907
"1842",2018,"Mississippi",12054,7132,608,1014,20808
"1843",2018,"Missouri",27559,21245,3069,3132,55005
"1844",2018,"Montana",3992,5369,420,664,10445
"1845",2018,"Nebraska",162,2411,50,18,2641
"1846",2018,"Nevada",6427,3625,531,696,11279
"1847",2018,"New Hampshire",7132,4245,370,18,11765
"1848",2018,"New Jersey",5178,4758,259,0,10195
"1849",2018,"New Mexico",8110,6046,837,1120,16113
"1850",2018,"New York",11578,17006,2533,610,31727
"1851",2018,"North Carolina",1808,16114,1705,568,20195
"1852",2018,"North Dakota",2195,3201,224,256,5876
"1853",2018,"Ohio",36314,24477,3483,3660,67934
"1854",2018,"Oklahoma",15682,12018,2117,2458,32275
"1855",2018,"Oregon",19409,15464,0,22,34895
"1856",2018,"Pennsylvania",67756,19867,53,0,87676
"1857",2018,"Puerto Rico",1718,182,131,60,2091
"1858",2018,"Rhode Island",1544,1261,327,654,3786
"1859",2018,"South Carolina",13772,7673,1113,1000,23558
"1860",2018,"South Dakota",3523,4408,348,436,8715
"1861",2018,"Tennessee",32501,19418,1997,0,53916
"1862",2018,"Texas",60134,38853,5634,6680,111301
"1863",2018,"Utah",5277,5296,601,0,11174
"1864",2018,"Vermont",2818,2713,440,372,6343
"1865",2018,"Virgin Islands",36,1,0,0,37
"1866",2018,"Virginia",30568,19180,4820,0,54568
"1867",2018,"Washington",22041,15774,3491,1690,42996
"1868",2018,"West Virginia",9955,8325,701,1208,20189
"1869",2018,"Wisconsin",19901,18290,1936,122,40249
"1870",2018,"Wyoming",2502,2536,252,322,5612
"1871",2018,"Alabama",9220,7172,353,980,17725
"1872",2018,"Alaska",2279,1948,268,332,4827
"1873",2018,"Arizona",14966,9058,1341,1868,27233
"1874",2018,"Arkansas",7671,6405,338,1228,15642
"1875",2018,"California",38531,24768,3940,0,67239
"1876",2018,"Colorado",20604,13985,1701,2664,38954
"1877",2018,"Connecticut",5918,2269,462,0,8649
"1878",2018,"Delaware",1852,1579,187,214,3832
"1879",2018,"District of Columbia",62,3,0,2,67
"1880",2018,"Florida",57435,26441,4590,5078,93544
"1881",2018,"Georgia",17618,9410,616,1800,29444
"1882",2018,"Guam",94,33,12,12,151
"1883",2018,"Hawaii",0,0,0,0,0
"1884",2018,"Idaho",4196,4300,396,538,9430
"1885",2018,"Illinois",25626,12938,0,2486,41050
"1886",2018,"Indiana",24019,13516,2056,2036,41627
"1887",2018,"Iowa",156,2587,46,16,2805
"1888",2018,"Kansas",7467,5818,638,1056,14979
"1889",2018,"Kentucky",13917,9302,532,2002,25753
"1890",2018,"Louisiana",11907,7865,902,1570,22244
"1891",2018,"Maine",3556,2797,300,444,7097
"1892",2018,"Mariana Islands",8,9,2,2,21
"1893",2018,"Maryland",4424,5496,149,112,10181
"1894",2018,"Massachusetts",5271,3035,459,418,9183
"1895",2018,"Michigan",12934,9602,768,570,23874
"1896",2018,"Minnesota",5034,7148,597,484,13263
"1897",2018,"Mississippi",11031,6516,359,1160,19066
"1898",2018,"Missouri",23601,17167,1927,3134,45829
"1899",2018,"Montana",2834,3401,258,710,7203
"1900",2018,"Nebraska",122,1973,32,12,2139
"1901",2018,"Nevada",5510,2898,335,534,9277
"1902",2018,"New Hampshire",5778,3076,176,10,9040
"1903",2018,"New Jersey",4613,3646,200,0,8459
"1904",2018,"New Mexico",7244,4985,545,868,13642
"1905",2018,"New York",10345,13742,1603,394,26084
"1906",2018,"North Carolina",1642,13498,1104,912,17156
"1907",2018,"North Dakota",1713,2220,149,148,4230
"1908",2018,"Ohio",30691,19698,2193,3598,56180
"1909",2018,"Oklahoma",13836,10146,1508,2608,28098
"1910",2018,"Oregon",15672,11370,0,22,27064
"1911",2018,"Pennsylvania",51425,14849,34,0,66308
"1912",2018,"Puerto Rico",1738,152,139,66,2095
"1913",2018,"Rhode Island",1272,886,220,418,2796
"1914",2018,"South Carolina",12843,6512,862,1072,21289
"1915",2018,"South Dakota",2844,3476,232,406,6958
"1916",2018,"Tennessee",31159,16929,1818,0,49906
"1917",2018,"Texas",55634,35889,4158,7424,103105
"1918",2018,"Utah",4175,4055,425,0,8655
"1919",2018,"Vermont",1876,1708,160,216,3960
"1920",2018,"Virgin Islands",30,8,0,0,38
"1921",2018,"Virginia",26596,15770,3483,0,45849
"1922",2018,"Washington",17287,11842,2605,1690,33424
"1923",2018,"West Virginia",8193,6582,424,1404,16603
"1924",2018,"Wisconsin",15379,11979,1187,146,28691
"1925",2018,"Wyoming",1851,1916,142,244,4153
"1926",2018,"Alabama",5692,6199,276,576,12743
"1927",2018,"Alaska",1844,1621,249,274,3988
"1928",2018,"Arizona",11659,6992,1074,1062,20787
"1929",2018,"Arkansas",4935,5061,232,646,10874
"1930",2018,"California",37335,22919,3495,0,63749
"1931",2018,"Colorado",17498,12153,1307,2140,33098
"1932",2018,"Connecticut",5044,1829,384,0,7257
"1933",2018,"Delaware",1422,1224,91,120,2857
"1934",2018,"District of Columbia",72,4,0,0,76
"1935",2018,"Florida",48377,20690,3299,3474,75840
"1936",2018,"Georgia",10836,7309,477,882,19504
"1937",2018,"Guam",74,43,11,14,142
"1938",2018,"Hawaii",0,0,0,0,0
"1939",2018,"Idaho",3001,3270,312,326,6909
"1940",2018,"Illinois",21821,9850,0,1534,33205
"1941",2018,"Indiana",17558,10258,1456,1382,30654
"1942",2018,"Iowa",119,2004,59,6,2188
"1943",2018,"Kansas",5249,4814,537,586,11186
"1944",2018,"Kentucky",8202,5736,323,788,15049
"1945",2018,"Louisiana",8500,7747,747,822,17816
"1946",2018,"Maine",2585,1926,230,304,5045
"1947",2018,"Mariana Islands",5,5,0,0,10
"1948",2018,"Maryland",4632,4405,155,60,9252
"1949",2018,"Massachusetts",4554,2468,421,256,7699
"1950",2018,"Michigan",8499,6395,532,324,15750
"1951",2018,"Minnesota",4279,4952,484,386,10101
"1952",2018,"Mississippi",6247,5310,306,538,12401
"1953",2018,"Missouri",17240,12403,1364,1642,32649
"1954",2018,"Montana",1930,2749,180,400,5259
"1955",2018,"Nebraska",106,1717,31,6,1860
"1956",2018,"Nevada",4280,2217,303,474,7274
"1957",2018,"New Hampshire",4277,2352,138,4,6771
"1958",2018,"New Jersey",4309,3491,210,0,8010
"1959",2018,"New Mexico",4995,3801,462,510,9768
"1960",2018,"New York",9091,10156,1126,326,20699
"1961",2018,"North Carolina",1271,9931,855,386,12443
"1962",2018,"North Dakota",1331,1914,130,134,3509
"1963",2018,"Ohio",21340,12521,1704,1796,37361
"1964",2018,"Oklahoma",9971,8351,1072,1620,21014
"1965",2018,"Oregon",12689,8976,0,8,21673
"1966",2018,"Pennsylvania",37308,10242,27,0,47577
"1967",2018,"Puerto Rico",1693,168,101,66,2028
"1968",2018,"Rhode Island",1010,618,64,294,1986
"1969",2018,"South Carolina",7896,5151,667,604,14318
"1970",2018,"South Dakota",2217,2799,191,268,5475
"1971",2018,"Tennessee",21023,12372,1125,0,34520
"1972",2018,"Texas",40443,29960,3400,4206,78009
"1973",2018,"Utah",3181,3135,316,0,6632
"1974",2018,"Vermont",1116,1000,105,78,2299
"1975",2018,"Virgin Islands",40,7,0,0,47
"1976",2018,"Virginia",19443,12248,2374,0,34065
"1977",2018,"Washington",16327,9811,2170,1246,29554
"1978",2018,"West Virginia",5128,4452,316,616,10512
"1979",2018,"Wisconsin",10484,8337,945,98,19864
"1980",2018,"Wyoming",1460,1534,138,182,3314
"1981",2017,"Alabama",12895,15765,390,1026,30076
"1982",2017,"Alaska",3675,3524,287,348,7834
"1983",2017,"Arizona",17566,12840,1414,1568,33388
"1984",2017,"Arkansas",9189,13104,347,880,23520
"1985",2017,"California",47613,35240,4885,0,87738
"1986",2017,"Colorado",26649,21168,1736,2570,52123
"1987",2017,"Connecticut",6646,2630,430,0,9706
"1988",2017,"Delaware",2295,2473,126,212,5106
"1989",2017,"District of Columbia",60,5,0,0,65
"1990",2017,"Florida",68075,37127,4067,4990,114259
"1991",2017,"Georgia",21017,20162,677,1472,43328
"1992",2017,"Guam",90,68,18,10,186
"1993",2017,"Hawaii",0,0,0,0,0
"1994",2017,"Idaho",5911,7393,360,524,14188
"1995",2017,"Illinois",27956,15126,0,1884,44966
"1996",2017,"Indiana",26719,19906,1839,1878,50342
"1997",2017,"Iowa",231,4678,48,14,4971
"1998",2017,"Kansas",9164,10222,597,918,20901
"1999",2017,"Kentucky",16727,16102,502,1308,34639
"2000",2017,"Louisiana",15819,20448,981,1622,38870
"2001",2017,"Maine",3873,4336,289,378,8876
"2002",2017,"Mariana Islands",10,8,2,6,26
"2003",2017,"Maryland",4611,8110,253,52,13026
"2004",2017,"Massachusetts",5954,3448,432,380,10214
"2005",2017,"Michigan",13425,13836,641,468,28370
"2006",2017,"Minnesota",5940,10334,596,476,17346
"2007",2017,"Mississippi",12946,16470,418,1116,30950
"2008",2017,"Missouri",28561,27288,2007,2546,60402
"2009",2017,"Montana",4154,6060,249,496,10959
"2010",2017,"Nebraska",197,3773,32,8,4010
"2011",2017,"Nevada",6236,4188,386,698,11508
"2012",2017,"New Hampshire",5977,3690,155,10,9832
"2013",2017,"New Jersey",4039,5089,213,0,9341
"2014",2017,"New Mexico",8205,7494,556,756,17011
"2015",2017,"New York",10187,19662,1329,452,31630
"2016",2017,"North Carolina",2452,25060,1062,528,29102
"2017",2017,"North Dakota",2019,3285,104,176,5584
"2018",2017,"Ohio",34374,27651,1773,2862,66660
"2019",2017,"Oklahoma",17164,18071,1365,2336,38936
"2020",2017,"Oregon",18409,15342,0,2,33753
"2021",2017,"Pennsylvania",57826,19809,59,0,77694
"2022",2017,"Puerto Rico",2291,305,114,80,2790
"2023",2017,"Rhode Island",1169,790,94,366,2419
"2024",2017,"South Carolina",14549,14083,900,1056,30588
"2025",2017,"South Dakota",3537,5348,230,460,9575
"2026",2017,"Tennessee",37860,28825,1984,0,68669
"2027",2017,"Texas",70767,66779,4312,6976,148834
"2028",2017,"Utah",6429,8577,398,0,15404
"2029",2017,"Vermont",1722,1824,115,170,3831
"2030",2017,"Virgin Islands",22,1,0,0,23
"2031",2017,"Virginia",31084,25165,3408,0,59657
"2032",2017,"Washington",21090,16101,2466,1486,41143
"2033",2017,"West Virginia",10383,11484,399,1030,23296
"2034",2017,"Wisconsin",15745,14414,1051,76,31286
"2035",2017,"Wyoming",2763,3104,165,240,6272
"2036",2017,"Alabama",9927,11675,292,966,22860
"2037",2017,"Alaska",3132,3244,261,452,7089
"2038",2017,"Arizona",13763,10322,1092,1702,26879
"2039",2017,"Arkansas",6981,11574,237,1132,19924
"2040",2017,"California",44710,35910,4241,0,84861
"2041",2017,"Colorado",23682,17832,1483,2592,45589
"2042",2017,"Connecticut",5757,2708,358,0,8823
"2043",2017,"Delaware",1802,2244,105,158,4309
"2044",2017,"District of Columbia",71,3,0,0,74
"2045",2017,"Florida",61694,31631,3585,5244,102154
"2046",2017,"Georgia",16298,15244,495,1614,33651
"2047",2017,"Guam",71,44,10,4,129
"2048",2017,"Hawaii",0,0,0,0,0
"2049",2017,"Idaho",4603,6292,310,456,11661
"2050",2017,"Illinois",26122,16102,0,2314,44538
"2051",2017,"Indiana",22558,20820,1772,1882,47032
"2052",2017,"Iowa",280,4847,50,12,5189
"2053",2017,"Kansas",7493,9095,474,874,17936
"2054",2017,"Kentucky",12568,13718,365,1264,27915
"2055",2017,"Louisiana",13566,16288,780,1472,32106
"2056",2017,"Maine",3270,4056,220,360,7906
"2057",2017,"Mariana Islands",16,4,0,2,22
"2058",2017,"Maryland",4453,8436,254,82,13225
"2059",2017,"Massachusetts",5691,3782,439,316,10228
"2060",2017,"Michigan",14115,18434,549,498,33596
"2061",2017,"Minnesota",5407,11777,528,508,18220
"2062",2017,"Mississippi",9779,12312,322,1070,23483
"2063",2017,"Missouri",23099,26209,1428,2410,53146
"2064",2017,"Montana",3171,5243,186,450,9050
"2065",2017,"Nebraska",216,3612,18,16,3862
"2066",2017,"Nevada",5350,3425,318,754,9847
"2067",2017,"New Hampshire",5266,3743,132,16,9157
"2068",2017,"New Jersey",3771,5459,203,0,9433
"2069",2017,"New Mexico",7206,5820,437,660,14123
"2070",2017,"New York",9160,21742,1308,384,32594
"2071",2017,"North Carolina",2123,19943,860,540,23466
"2072",2017,"North Dakota",1924,3382,136,216,5658
"2073",2017,"Ohio",30973,28808,1690,3072,64543
"2074",2017,"Oklahoma",15302,15953,1223,3438,35916
"2075",2017,"Oregon",15988,13094,0,22,29104
"2076",2017,"Pennsylvania",54967,21597,44,0,76608
"2077",2017,"Puerto Rico",1926,257,79,60,2322
"2078",2017,"Rhode Island",1082,742,142,340,2306
"2079",2017,"South Carolina",11512,10108,563,1096,23279
"2080",2017,"South Dakota",3049,5354,242,376,9021
"2081",2017,"Tennessee",31618,23889,1635,0,57142
"2082",2017,"Texas",59840,51536,3450,7150,121976
"2083",2017,"Utah",5158,6418,320,0,11896
"2084",2017,"Vermont",1231,1839,100,118,3288
"2085",2017,"Virgin Islands",29,1,0,0,30
"2086",2017,"Virginia",26229,22897,3007,0,52133
"2087",2017,"Washington",18326,14345,2281,1428,36380
"2088",2017,"West Virginia",7302,10878,302,892,19374
"2089",2017,"Wisconsin",14237,18174,823,126,33360
"2090",2017,"Wyoming",2165,2545,148,268,5126
"2091",2017,"Alabama",6144,6999,308,674,14125
"2092",2017,"Alaska",3153,3469,333,478,7433
"2093",2017,"Arizona",10614,8055,1100,1378,21147
"2094",2017,"Arkansas",4873,7420,249,676,13218
"2095",2017,"California",39879,25749,3646,0,69274
"2096",2017,"Colorado",17238,15967,1428,2318,36951
"2097",2017,"Connecticut",5112,2233,310,0,7655
"2098",2017,"Delaware",1602,1587,86,132,3407
"2099",2017,"District of Columbia",68,2,0,4,74
"2100",2017,"Florida",49568,24580,3958,4178,82284
"2101",2017,"Georgia",12031,10482,483,1076,24072
"2102",2017,"Guam",84,35,11,6,136
"2103",2017,"Hawaii",0,0,0,0,0
"2104",2017,"Idaho",3310,5517,269,444,9540
"2105",2017,"Illinois",20093,12503,0,1608,34204
"2106",2017,"Indiana",15966,13202,1450,1306,31924
"2107",2017,"Iowa",126,3209,29,6,3370
"2108",2017,"Kansas",5003,5818,433,692,11946
"2109",2017,"Kentucky",8758,8739,371,992,18860
"2110",2017,"Louisiana",9552,12222,827,1234,23835
"2111",2017,"Maine",3076,5806,252,406,9540
"2112",2017,"Mariana Islands",4,4,0,2,10
"2113",2017,"Maryland",4332,5991,213,76,10612
"2114",2017,"Massachusetts",4950,3030,450,274,8704
"2115",2017,"Michigan",9807,12649,522,424,23402
"2116",2017,"Minnesota",4834,14555,516,554,20459
"2117",2017,"Mississippi",6690,7193,302,826,15011
"2118",2017,"Missouri",17985,19508,1464,2236,41193
"2119",2017,"Montana",2578,5884,189,434,9085
"2120",2017,"Nebraska",118,2469,11,8,2606
"2121",2017,"Nevada",4361,2884,360,602,8207
"2122",2017,"New Hampshire",4425,3568,147,10,8150
"2123",2017,"New Jersey",3798,3869,185,0,7852
"2124",2017,"New Mexico",5651,4928,465,602,11646
"2125",2017,"New York",8501,17695,1320,412,27928
"2126",2017,"North Carolina",1501,13877,757,478,16613
"2127",2017,"North Dakota",1367,3732,134,172,5405
"2128",2017,"Ohio",22833,18172,1593,2212,44810
"2129",2017,"Oklahoma",9485,10552,1066,1912,23015
"2130",2017,"Oregon",12356,11042,0,10,23408
"2131",2017,"Pennsylvania",43923,15604,67,0,59594
"2132",2017,"Puerto Rico",1116,124,53,14,1307
"2133",2017,"Rhode Island",937,799,120,384,2240
"2134",2017,"South Carolina",8269,7166,444,710,16589
"2135",2017,"South Dakota",2098,5636,182,318,8234
"2136",2017,"Tennessee",21614,16131,1285,0,39030
"2137",2017,"Texas",41780,39297,3633,5060,89770
"2138",2017,"Utah",3075,4257,287,0,7619
"2139",2017,"Vermont",1324,1935,109,172,3540
"2140",2017,"Virgin Islands",19,0,0,0,19
"2141",2017,"Virginia",20450,16169,2637,0,39256
"2142",2017,"Washington",14867,13022,2092,1276,31257
"2143",2017,"West Virginia",5527,7375,350,760,14012
"2144",2017,"Wisconsin",11834,15385,830,120,28169
"2145",2017,"Wyoming",1321,2107,119,174,3721
"2146",2017,"Alabama",5734,6320,221,634,12909
"2147",2017,"Alaska",2320,2930,219,320,5789
"2148",2017,"Arizona",11063,7946,920,1262,21191
"2149",2017,"Arkansas",4347,6063,165,732,11307
"2150",2017,"California",37165,24581,2984,0,64730
"2151",2017,"Colorado",15751,13448,1007,2124,32330
"2152",2017,"Connecticut",4834,1993,274,0,7101
"2153",2017,"Delaware",1414,1538,66,136,3154
"2154",2017,"District of Columbia",56,4,0,0,60
"2155",2017,"Florida",39199,17949,2319,3442,62909
"2156",2017,"Georgia",10933,7982,315,988,20218
"2157",2017,"Guam",74,47,10,6,137
"2158",2017,"Hawaii",0,0,0,0,0
"2159",2017,"Idaho",3058,5241,187,410,8896
"2160",2017,"Illinois",18290,10201,0,1628,30119
"2161",2017,"Indiana",16093,11332,1123,1194,29742
"2162",2017,"Iowa",151,2640,27,2,2820
"2163",2017,"Kansas",4518,5025,306,594,10443
"2164",2017,"Kentucky",8112,7543,253,1086,16994
"2165",2017,"Louisiana",10495,11573,635,1552,24255
"2166",2017,"Maine",3026,4220,179,372,7797
"2167",2017,"Mariana Islands",12,3,0,2,17
"2168",2017,"Maryland",3389,4897,168,68,8522
"2169",2017,"Massachusetts",4749,2808,449,316,8322
"2170",2017,"Michigan",8654,10676,379,326,20035
"2171",2017,"Minnesota",4862,12677,346,546,18431
"2172",2017,"Mississippi",6260,6035,206,810,13311
"2173",2017,"Missouri",16993,14395,1050,1982,34420
"2174",2017,"Montana",2395,4878,140,432,7845
"2175",2017,"Nebraska",110,1989,11,8,2118
"2176",2017,"Nevada",3992,2509,251,474,7226
"2177",2017,"New Hampshire",4410,3248,132,6,7796
"2178",2017,"New Jersey",3985,3040,140,0,7165
"2179",2017,"New Mexico",5309,4508,353,568,10738
"2180",2017,"New York",8392,16213,998,370,25973
"2181",2017,"North Carolina",1235,11340,657,466,13698
"2182",2017,"North Dakota",1359,2919,99,164,4541
"2183",2017,"Ohio",21085,14998,1202,2052,39337
"2184",2017,"Oklahoma",8869,9020,741,1614,20244
"2185",2017,"Oregon",11557,11773,0,14,23344
"2186",2017,"Pennsylvania",39825,13222,48,0,53095
"2187",2017,"Puerto Rico",619,123,17,44,803
"2188",2017,"Rhode Island",907,619,70,326,1922
"2189",2017,"South Carolina",7574,6037,379,590,14580
"2190",2017,"South Dakota",2020,4155,154,282,6611
"2191",2017,"Tennessee",19219,13746,1042,0,34007
"2192",2017,"Texas",39119,39416,2768,4946,86249
"2193",2017,"Utah",2840,3960,212,0,7012
"2194",2017,"Vermont",1276,1591,90,160,3117
"2195",2017,"Virgin Islands",6,2,0,0,8
"2196",2017,"Virginia",19676,15075,1100,0,35851
"2197",2017,"Washington",13292,11548,1623,1174,27637
"2198",2017,"West Virginia",5204,6161,216,774,12355
"2199",2017,"Wisconsin",10918,13133,612,86,24749
"2200",2017,"Wyoming",1337,2015,61,194,3607
"2201",2017,"Alabama",6289,6045,216,622,13172
"2202",2017,"Alaska",2656,3097,207,368,6328
"2203",2017,"Arizona",10864,7686,908,1254,20712
"2204",2017,"Arkansas",4827,5297,220,646,10990
"2205",2017,"California",41110,26220,3058,0,70388
"2206",2017,"Colorado",16610,12925,1013,2070,32618
"2207",2017,"Connecticut",5289,1988,290,0,7567
"2208",2017,"Delaware",1571,1349,94,116,3130
"2209",2017,"District of Columbia",54,6,0,2,62
"2210",2017,"Florida",46682,21717,2847,4096,75342
"2211",2017,"Georgia",11719,7797,377,1050,20943
"2212",2017,"Guam",105,47,5,4,161
"2213",2017,"Hawaii",0,0,0,0,0
"2214",2017,"Idaho",3216,3966,186,410,7778
"2215",2017,"Illinois",19807,11333,0,1558,32698
"2216",2017,"Indiana",17271,11844,1132,1396,31643
"2217",2017,"Iowa",134,2002,21,6,2163
"2218",2017,"Kansas",5005,4743,330,660,10738
"2219",2017,"Kentucky",8039,6555,244,918,15756
"2220",2017,"Louisiana",10124,8788,632,1262,20806
"2221",2017,"Maine",3019,2965,196,326,6506
"2222",2017,"Mariana Islands",16,7,1,6,30
"2223",2017,"Maryland",3657,4807,153,54,8671
"2224",2017,"Massachusetts",4713,2507,457,342,8019
"2225",2017,"Michigan",9849,9962,415,498,20724
"2226",2017,"Minnesota",5446,11294,418,630,17788
"2227",2017,"Mississippi",9059,7738,251,1130,18178
"2228",2017,"Missouri",17369,13918,1227,2054,34568
"2229",2017,"Montana",2597,4034,128,442,7201
"2230",2017,"Nebraska",109,1667,16,14,1806
"2231",2017,"Nevada",4052,2251,229,482,7014
"2232",2017,"New Hampshire",4164,2885,121,6,7176
"2233",2017,"New Jersey",4238,3038,167,0,7443
"2234",2017,"New Mexico",5000,3734,396,662,9792
"2235",2017,"New York",9159,13239,891,316,23605
"2236",2017,"North Carolina",1194,11949,649,392,14184
"2237",2017,"North Dakota",1500,2567,92,130,4289
"2238",2017,"Ohio",21432,14447,1242,2068,39189
"2239",2017,"Oklahoma",9732,8978,819,1896,21425
"2240",2017,"Oregon",11780,8979,0,6,20765
"2241",2017,"Pennsylvania",40628,13170,78,0,53876
"2242",2017,"Puerto Rico",1169,227,42,68,1506
"2243",2017,"Rhode Island",883,596,68,308,1855
"2244",2017,"South Carolina",8268,6421,412,722,15823
"2245",2017,"South Dakota",2082,3233,180,222,5717
"2246",2017,"Tennessee",19965,14204,1191,0,35360
"2247",2017,"Texas",37277,34884,2093,4948,79202
"2248",2017,"Utah",2790,3154,190,0,6134
"2249",2017,"Vermont",1232,1254,94,178,2758
"2250",2017,"Virgin Islands",47,4,0,0,51
"2251",2017,"Virginia",20797,14926,1161,0,36884
"2252",2017,"Washington",13788,9776,1529,1246,26339
"2253",2017,"West Virginia",4946,4651,241,682,10520
"2254",2017,"Wisconsin",12749,14317,642,84,27792
"2255",2017,"Wyoming",1411,1762,62,172,3407
"2256",2017,"Alabama",6046,4790,224,516,11576
"2257",2017,"Alaska",2911,2458,238,360,5967
"2258",2017,"Arizona",10194,6363,999,1088,18644
"2259",2017,"Arkansas",4343,3804,189,508,8844
"2260",2017,"California",37027,21721,2514,0,61262
"2261",2017,"Colorado",16063,11065,1004,2040,30172
"2262",2017,"Connecticut",5450,1771,280,0,7501
"2263",2017,"Delaware",1417,1000,71,120,2608
"2264",2017,"District of Columbia",44,5,0,0,49
"2265",2017,"Florida",47430,18941,2975,3688,73034
"2266",2017,"Georgia",10685,6166,365,800,18016
"2267",2017,"Guam",71,45,15,28,159
"2268",2017,"Hawaii",0,0,0,0,0
"2269",2017,"Idaho",2887,3276,191,298,6652
"2270",2017,"Illinois",18417,9895,0,1530,29842
"2271",2017,"Indiana",15385,9995,950,1168,27498
"2272",2017,"Iowa",94,1649,22,8,1773
"2273",2017,"Kansas",4636,3914,325,556,9431
"2274",2017,"Kentucky",7236,5118,241,838,13433
"2275",2017,"Louisiana",9420,5992,663,1150,17225
"2276",2017,"Maine",2695,2259,144,244,5342
"2277",2017,"Mariana Islands",11,1,0,2,14
"2278",2017,"Maryland",3710,3922,172,36,7840
"2279",2017,"Massachusetts",4034,2150,332,236,6752
"2280",2017,"Michigan",9305,7687,339,416,17747
"2281",2017,"Minnesota",5181,7734,430,490,13835
"2282",2017,"Mississippi",5961,3980,247,640,10828
"2283",2017,"Missouri",16151,11098,1013,1714,29976
"2284",2017,"Montana",2307,3168,137,312,5924
"2285",2017,"Nebraska",97,1204,10,0,1311
"2286",2017,"Nevada",3647,1962,219,446,6274
"2287",2017,"New Hampshire",4228,2427,128,8,6791
"2288",2017,"New Jersey",4351,2519,164,0,7034
"2289",2017,"New Mexico",4834,3254,361,456,8905
"2290",2017,"New York",9212,11301,879,340,21732
"2291",2017,"North Carolina",1059,9316,551,360,11286
"2292",2017,"North Dakota",1286,2030,85,124,3525
"2293",2017,"Ohio",20990,14131,1227,1918,38266
"2294",2017,"Oklahoma",9377,6698,882,1336,18293
"2295",2017,"Oregon",11160,7877,0,2,19039
"2296",2017,"Pennsylvania",37329,11694,159,0,49182
"2297",2017,"Puerto Rico",1115,187,44,44,1390
"2298",2017,"Rhode Island",836,593,64,258,1751
"2299",2017,"South Carolina",7458,4622,405,654,13139
"2300",2017,"South Dakota",1926,2355,200,198,4679
"2301",2017,"Tennessee",20279,11425,1125,0,32829
"2302",2017,"Texas",36913,27245,2653,4386,71197
"2303",2017,"Utah",2562,2546,202,0,5310
"2304",2017,"Vermont",1127,1012,87,94,2320
"2305",2017,"Virgin Islands",39,6,1,4,50
"2306",2017,"Virginia",20688,13381,971,0,35040
"2307",2017,"Washington",12872,8636,1503,1130,24141
"2308",2017,"West Virginia",4860,4535,231,656,10282
"2309",2017,"Wisconsin",11537,9946,585,88,22156
"2310",2017,"Wyoming",1231,1395,82,154,2862
"2311",2017,"Alabama",8275,4782,254,668,13979
"2312",2017,"Alaska",2909,2254,225,380,5768
"2313",2017,"Arizona",11507,6726,947,1212,20392
"2314",2017,"Arkansas",5634,4070,190,584,10478
"2315",2017,"California",42726,23807,2763,0,69296
"2316",2017,"Colorado",17781,11298,1151,2076,32306
"2317",2017,"Connecticut",6203,1765,243,0,8211
"2318",2017,"Delaware",1724,1082,74,132,3012
"2319",2017,"District of Columbia",52,5,0,0,57
"2320",2017,"Florida",52114,19380,3260,4024,78778
"2321",2017,"Georgia",13617,6474,394,994,21479
"2322",2017,"Guam",94,42,8,20,164
"2323",2017,"Hawaii",0,0,0,0,0
"2324",2017,"Idaho",3645,3698,184,368,7895
"2325",2017,"Illinois",21394,9491,0,1580,32465
"2326",2017,"Indiana",18351,9706,1093,1056,30206
"2327",2017,"Iowa",98,1641,36,6,1781
"2328",2017,"Kansas",5625,3788,355,560,10328
"2329",2017,"Kentucky",8765,5223,265,938,15191
"2330",2017,"Louisiana",11706,6324,859,1080,19969
"2331",2017,"Maine",3064,2188,210,310,5772
"2332",2017,"Mariana Islands",9,2,0,2,13
"2333",2017,"Maryland",3968,3963,250,38,8219
"2334",2017,"Massachusetts",5612,2287,329,298,8526
"2335",2017,"Michigan",11170,7578,463,400,19611
"2336",2017,"Minnesota",6258,7505,515,572,14850
"2337",2017,"Mississippi",7987,4029,268,764,13048
"2338",2017,"Missouri",19459,11470,1200,1870,33999
"2339",2017,"Montana",3026,3727,162,424,7339
"2340",2017,"Nebraska",99,1261,22,4,1386
"2341",2017,"Nevada",4449,2337,242,438,7466
"2342",2017,"New Hampshire",4836,2412,164,4,7416
"2343",2017,"New Jersey",5022,2586,182,0,7790
"2344",2017,"New Mexico",5152,3486,421,522,9581
"2345",2017,"New York",10784,11309,921,392,23406
"2346",2017,"North Carolina",1581,9570,558,456,12165
"2347",2017,"North Dakota",1426,1942,97,118,3583
"2348",2017,"Ohio",23703,13536,1324,1946,40509
"2349",2017,"Oklahoma",11872,7459,942,1556,21829
"2350",2017,"Oregon",13632,9218,0,2,22852
"2351",2017,"Pennsylvania",41408,11117,200,0,52725
"2352",2017,"Puerto Rico",1339,211,32,70,1652
"2353",2017,"Rhode Island",1053,592,65,302,2012
"2354",2017,"South Carolina",11431,4533,473,890,17327
"2355",2017,"South Dakota",2215,2458,244,284,5201
"2356",2017,"Tennessee",23369,11558,1237,0,36164
"2357",2017,"Texas",48895,29119,3000,4614,85628
"2358",2017,"Utah",3307,2989,208,0,6504
"2359",2017,"Vermont",1296,973,71,82,2422
"2360",2017,"Virgin Islands",25,2,0,0,27
"2361",2017,"Virginia",22416,12706,959,0,36081
"2362",2017,"Washington",16674,9805,1694,1208,29381
"2363",2017,"West Virginia",5409,4165,229,656,10459
"2364",2017,"Wisconsin",13463,9959,640,82,24144
"2365",2017,"Wyoming",1520,1544,107,170,3341
"2366",2017,"Alabama",7198,4559,254,618,12629
"2367",2017,"Alaska",2851,2459,216,340,5866
"2368",2017,"Arizona",12002,6555,951,1242,20750
"2369",2017,"Arkansas",5181,3981,217,550,9929
"2370",2017,"California",42442,24495,2760,0,69697
"2371",2017,"Colorado",17085,11165,1102,1976,31328
"2372",2017,"Connecticut",5951,1862,222,0,8035
"2373",2017,"Delaware",1752,1087,69,144,3052
"2374",2017,"District of Columbia",66,4,0,4,74
"2375",2017,"Florida",49700,18476,3001,3814,74991
"2376",2017,"Georgia",12163,6211,406,884,19664
"2377",2017,"Guam",93,49,7,16,165
"2378",2017,"Hawaii",0,0,0,0,0
"2379",2017,"Idaho",3267,3699,194,362,7522
"2380",2017,"Illinois",22244,9252,0,1548,33044
"2381",2017,"Indiana",18110,9483,1060,1236,29889
"2382",2017,"Iowa",196,1759,53,6,2014
"2383",2017,"Kansas",5022,3818,369,590,9799
"2384",2017,"Kentucky",8690,5378,223,866,15157
"2385",2017,"Louisiana",10362,6302,731,1088,18483
"2386",2017,"Maine",3236,2540,224,368,6368
"2387",2017,"Mariana Islands",10,1,1,0,12
"2388",2017,"Maryland",4539,4244,212,60,9055
"2389",2017,"Massachusetts",5100,2526,359,328,8313
"2390",2017,"Michigan",10483,7055,402,382,18322
"2391",2017,"Minnesota",7916,7597,631,654,16798
"2392",2017,"Mississippi",7002,3938,277,652,11869
"2393",2017,"Missouri",18290,11468,1067,1714,32539
"2394",2017,"Montana",2660,3762,170,398,6990
"2395",2017,"Nebraska",109,1256,23,10,1398
"2396",2017,"Nevada",4630,2288,242,468,7628
"2397",2017,"New Hampshire",4614,2472,158,10,7254
"2398",2017,"New Jersey",5569,2931,194,0,8694
"2399",2017,"New Mexico",5204,3381,394,526,9505
"2400",2017,"New York",11633,12857,957,366,25813
"2401",2017,"North Carolina",1363,9129,673,412,11577
"2402",2017,"North Dakota",1413,1866,95,114,3488
"2403",2017,"Ohio",25230,12924,1375,2118,41647
"2404",2017,"Oklahoma",10599,7270,897,1456,20222
"2405",2017,"Oregon",13261,9115,0,6,22382
"2406",2017,"Pennsylvania",42646,11123,157,0,53926
"2407",2017,"Puerto Rico",1279,217,67,62,1625
"2408",2017,"Rhode Island",1048,541,82,364,2035
"2409",2017,"South Carolina",9258,4234,494,1234,15220
"2410",2017,"South Dakota",2369,2578,253,290,5490
"2411",2017,"Tennessee",22198,10745,1187,0,34130
"2412",2017,"Texas",42366,27991,2991,4452,77800
"2413",2017,"Utah",3204,3144,214,0,6562
"2414",2017,"Vermont",1306,1132,83,98,2619
"2415",2017,"Virgin Islands",19,1,0,4,24
"2416",2017,"Virginia",21697,12181,969,0,34847
"2417",2017,"Washington",15915,9682,1617,1168,28382
"2418",2017,"West Virginia",5818,4329,262,642,11051
"2419",2017,"Wisconsin",14070,9467,709,116,24362
"2420",2017,"Wyoming",1589,1578,101,182,3450
"2421",2017,"Alabama",7131,4724,229,522,12606
"2422",2017,"Alaska",2997,2840,221,466,6524
"2423",2017,"Arizona",13302,7485,1109,1316,23212
"2424",2017,"Arkansas",5670,4226,191,574,10661
"2425",2017,"California",45182,24898,3104,0,73184
"2426",2017,"Colorado",19453,12407,1268,2136,35264
"2427",2017,"Connecticut",6557,2063,178,0,8798
"2428",2017,"Delaware",2017,1249,90,178,3534
"2429",2017,"District of Columbia",68,1,0,0,69
"2430",2017,"Florida",52889,19489,3290,3680,79348
"2431",2017,"Georgia",13202,6567,463,842,21074
"2432",2017,"Guam",93,39,9,12,153
"2433",2017,"Hawaii",0,0,0,0,0
"2434",2017,"Idaho",3874,4039,196,320,8429
"2435",2017,"Illinois",25414,10416,0,1690,37520
"2436",2017,"Indiana",21454,11390,1158,1354,35356
"2437",2017,"Iowa",252,2348,56,6,2662
"2438",2017,"Kansas",5901,4435,402,616,11354
"2439",2017,"Kentucky",9858,6519,257,866,17500
"2440",2017,"Louisiana",10551,6161,797,984,18493
"2441",2017,"Maine",3816,3073,242,366,7497
"2442",2017,"Mariana Islands",11,2,0,0,13
"2443",2017,"Maryland",4435,5128,227,48,9838
"2444",2017,"Massachusetts",6540,2717,411,388,10056
"2445",2017,"Michigan",12478,9139,524,492,22633
"2446",2017,"Minnesota",13074,12144,885,1080,27183
"2447",2017,"Mississippi",7952,4359,245,588,13144
"2448",2017,"Missouri",20328,14124,1233,1996,37681
"2449",2017,"Montana",3014,4246,162,438,7860
"2450",2017,"Nebraska",126,1648,15,8,1797
"2451",2017,"Nevada",4890,2747,243,574,8454
"2452",2017,"New Hampshire",5658,3121,165,18,8962
"2453",2017,"New Jersey",5722,3201,196,0,9119
"2454",2017,"New Mexico",5665,4023,502,534,10724
"2455",2017,"New York",11913,14591,1111,408,28023
"2456",2017,"North Carolina",1471,9870,678,370,12389
"2457",2017,"North Dakota",2209,2492,107,198,5006
"2458",2017,"Ohio",31417,16030,1580,2418,51445
"2459",2017,"Oklahoma",13317,9111,1159,1724,25311
"2460",2017,"Oregon",15122,10896,0,4,26022
"2461",2017,"Pennsylvania",48255,11877,97,0,60229
"2462",2017,"Puerto Rico",1105,204,45,52,1406
"2463",2017,"Rhode Island",1146,673,82,400,2301
"2464",2017,"South Carolina",9548,4420,515,2318,16801
"2465",2017,"South Dakota",2896,3008,308,296,6508
"2466",2017,"Tennessee",23031,11521,1164,0,35716
"2467",2017,"Texas",44994,28015,3098,4884,80991
"2468",2017,"Utah",3917,3302,226,0,7445
"2469",2017,"Vermont",1855,1720,124,210,3909
"2470",2017,"Virgin Islands",22,7,0,0,29
"2471",2017,"Virginia",29480,16844,1227,0,47551
"2472",2017,"Washington",17120,10659,1750,1260,30789
"2473",2017,"West Virginia",6723,5263,257,730,12973
"2474",2017,"Wisconsin",16700,13302,873,92,30967
"2475",2017,"Wyoming",1633,1711,108,170,3622
"2476",2017,"Alabama",10603,6951,313,774,18641
"2477",2017,"Alaska",3067,2640,242,368,6317
"2478",2017,"Arizona",14897,9036,1120,1476,26529
"2479",2017,"Arkansas",7907,6010,281,908,15106
"2480",2017,"California",48732,27839,3032,0,79603
"2481",2017,"Colorado",21249,14378,1528,2362,39517
"2482",2017,"Connecticut",7476,2551,182,0,10209
"2483",2017,"Delaware",2557,1677,95,220,4549
"2484",2017,"District of Columbia",83,3,0,2,88
"2485",2017,"Florida",60787,23982,3609,4352,92730
"2486",2017,"Georgia",19256,9518,533,1352,30659
"2487",2017,"Guam",74,41,7,26,148
"2488",2017,"Hawaii",0,0,0,0,0
"2489",2017,"Idaho",4500,4944,289,486,10219
"2490",2017,"Illinois",30518,14411,0,2414,47343
"2491",2017,"Indiana",28593,14363,1575,1586,46117
"2492",2017,"Iowa",316,3137,62,8,3523
"2493",2017,"Kansas",7712,5522,558,720,14512
"2494",2017,"Kentucky",13769,8992,347,1290,24398
"2495",2017,"Louisiana",13973,8092,988,1524,24577
"2496",2017,"Maine",4558,3286,305,394,8543
"2497",2017,"Mariana Islands",9,1,1,0,11
"2498",2017,"Maryland",5398,5737,292,42,11469
"2499",2017,"Massachusetts",7274,3421,464,370,11529
"2500",2017,"Michigan",16031,11103,617,546,28297
"2501",2017,"Minnesota",14029,12988,1131,1036,29184
"2502",2017,"Mississippi",11586,6508,344,930,19368
"2503",2017,"Missouri",27625,17931,1537,2572,49665
"2504",2017,"Montana",3615,4584,299,562,9060
"2505",2017,"Nebraska",176,1984,24,14,2198
"2506",2017,"Nevada",6038,3219,298,602,10157
"2507",2017,"New Hampshire",7278,3462,227,6,10973
"2508",2017,"New Jersey",6871,3864,258,0,10993
"2509",2017,"New Mexico",6752,4571,524,748,12595
"2510",2017,"New York",12788,15591,1245,408,30032
"2511",2017,"North Carolina",1669,13837,875,522,16903
"2512",2017,"North Dakota",2013,2371,124,140,4648
"2513",2017,"Ohio",37474,19925,2384,2962,62745
"2514",2017,"Oklahoma",14157,10065,1118,1954,27294
"2515",2017,"Oregon",17177,13521,0,0,30698
"2516",2017,"Pennsylvania",61207,15836,86,0,77129
"2517",2017,"Puerto Rico",1267,206,48,56,1577
"2518",2017,"Rhode Island",1424,791,83,446,2744
"2519",2017,"South Carolina",13284,6749,680,1382,22095
"2520",2017,"South Dakota",3361,3686,342,476,7865
"2521",2017,"Tennessee",29369,15922,1526,0,46817
"2522",2017,"Texas",55983,34308,3702,5692,99685
"2523",2017,"Utah",4401,4010,284,0,8695
"2524",2017,"Vermont",2007,1793,125,218,4143
"2525",2017,"Virgin Islands",27,5,0,0,32
"2526",2017,"Virginia",29873,17754,1193,0,48820
"2527",2017,"Washington",20308,12740,2224,1470,36742
"2528",2017,"West Virginia",8887,6616,324,1046,16873
"2529",2017,"Wisconsin",19864,16763,1105,82,37814
"2530",2017,"Wyoming",2017,2038,134,248,4437
"2531",2017,"Alabama",10739,7028,291,1010,19068
"2532",2017,"Alaska",2857,2102,191,360,5510
"2533",2017,"Arizona",15642,8881,984,1642,27149
"2534",2017,"Arkansas",7974,5938,237,1180,15329
"2535",2017,"California",44363,24987,2898,0,72248
"2536",2017,"Colorado",20958,13477,1235,2480,38150
"2537",2017,"Connecticut",6445,2187,138,0,8770
"2538",2017,"Delaware",2342,1663,64,204,4273
"2539",2017,"District of Columbia",65,1,0,4,70
"2540",2017,"Florida",59201,23479,2928,4374,89982
"2541",2017,"Georgia",19007,9334,454,1726,30521
"2542",2017,"Guam",74,43,11,6,134
"2543",2017,"Hawaii",0,0,0,0,0
"2544",2017,"Idaho",4051,3904,230,454,8639
"2545",2017,"Illinois",27418,12635,0,2004,42057
"2546",2017,"Indiana",27343,13221,1288,1628,43480
"2547",2017,"Iowa",318,2403,34,24,2779
"2548",2017,"Kansas",8082,5501,511,860,14954
"2549",2017,"Kentucky",14975,8636,253,2088,25952
"2550",2017,"Louisiana",12698,7601,846,1336,22481
"2551",2017,"Maine",3758,2544,227,338,6867
"2552",2017,"Mariana Islands",0,0,0,0,0
"2553",2017,"Maryland",4925,5534,213,90,10762
"2554",2017,"Massachusetts",6280,2901,404,312,9897
"2555",2017,"Michigan",15564,9804,553,526,26447
"2556",2017,"Minnesota",12047,9641,791,750,23229
"2557",2017,"Mississippi",11285,6045,279,1160,18769
"2558",2017,"Missouri",26726,16012,1393,2954,47085
"2559",2017,"Montana",2912,3429,177,618,7136
"2560",2017,"Nebraska",171,1937,19,12,2139
"2561",2017,"Nevada",5644,2732,301,616,9293
"2562",2017,"New Hampshire",6092,3098,156,4,9350
"2563",2017,"New Jersey",5904,3481,216,0,9601
"2564",2017,"New Mexico",7032,4632,400,1018,13082
"2565",2017,"New York",11465,14080,1128,358,27031
"2566",2017,"North Carolina",1410,13488,780,830,16508
"2567",2017,"North Dakota",1807,2213,83,154,4257
"2568",2017,"Ohio",36244,18068,2030,3166,59508
"2569",2017,"Oklahoma",14051,9769,933,2422,27175
"2570",2017,"Oregon",16425,11726,0,0,28151
"2571",2017,"Pennsylvania",54107,12734,37,0,66878
"2572",2017,"Puerto Rico",1000,197,30,48,1275
"2573",2017,"Rhode Island",1278,731,94,418,2521
"2574",2017,"South Carolina",12510,6324,637,5358,24829
"2575",2017,"South Dakota",3569,3533,287,340,7729
"2576",2017,"Tennessee",31982,16425,1559,0,49966
"2577",2017,"Texas",56786,33238,3083,7046,100153
"2578",2017,"Utah",4371,4252,262,0,8885
"2579",2017,"Vermont",1885,1538,104,118,3645
"2580",2017,"Virgin Islands",26,8,0,0,34
"2581",2017,"Virginia",28434,16587,1170,0,46191
"2582",2017,"Washington",18785,11860,2185,1684,34514
"2583",2017,"West Virginia",8917,6203,281,1336,16737
"2584",2017,"Wisconsin",18147,12247,858,114,31366
"2585",2017,"Wyoming",1839,1646,123,226,3834
"2586",2017,"Alabama",6770,6572,301,556,14199
"2587",2017,"Alaska",2028,1631,187,254,4100
"2588",2017,"Arizona",12108,7353,951,1100,21512
"2589",2017,"Arkansas",5174,5278,242,626,11320
"2590",2017,"California",41516,22686,2898,0,67100
"2591",2017,"Colorado",17189,11864,1128,1964,32145
"2592",2017,"Connecticut",6133,2115,118,0,8366
"2593",2017,"Delaware",1815,1466,81,114,3476
"2594",2017,"District of Columbia",69,6,0,0,75
"2595",2017,"Florida",51599,21867,3129,3632,80227
"2596",2017,"Georgia",12519,7945,460,752,21676
"2597",2017,"Guam",118,66,12,18,214
"2598",2017,"Hawaii",0,0,0,0,0
"2599",2017,"Idaho",2617,3049,207,244,6117
"2600",2017,"Illinois",24594,11185,0,1534,37313
"2601",2017,"Indiana",21284,11456,1261,1214,35215
"2602",2017,"Iowa",180,2015,40,8,2243
"2603",2017,"Kansas",5798,4969,434,524,11725
"2604",2017,"Kentucky",9743,6700,292,794,17529
"2605",2017,"Louisiana",10709,8701,819,944,21173
"2606",2017,"Maine",3094,2447,260,284,6085
"2607",2017,"Mariana Islands",0,2,0,0,2
"2608",2017,"Maryland",4456,5254,185,48,9943
"2609",2017,"Massachusetts",6069,2871,379,308,9627
"2610",2017,"Michigan",10181,7490,527,308,18506
"2611",2017,"Minnesota",9389,7266,851,638,18144
"2612",2017,"Mississippi",6805,5592,298,496,13191
"2613",2017,"Missouri",20123,13512,1257,1714,36606
"2614",2017,"Montana",2015,2748,172,278,5213
"2615",2017,"Nebraska",141,1673,26,6,1846
"2616",2017,"Nevada",4235,2361,279,452,7327
"2617",2017,"New Hampshire",5332,2836,142,12,8322
"2618",2017,"New Jersey",5719,3355,200,0,9274
"2619",2017,"New Mexico",4781,3641,394,466,9282
"2620",2017,"New York",11059,13412,1062,342,25875
"2621",2017,"North Carolina",1073,11218,802,376,13469
"2622",2017,"North Dakota",1370,1892,113,136,3511
"2623",2017,"Ohio",27124,15070,1696,1990,45880
"2624",2017,"Oklahoma",10811,8883,1004,1410,22108
"2625",2017,"Oregon",12071,8985,0,0,21056
"2626",2017,"Pennsylvania",44199,10689,50,0,54938
"2627",2017,"Puerto Rico",1072,181,50,40,1343
"2628",2017,"Rhode Island",1196,687,78,320,2281
"2629",2017,"South Carolina",9374,5678,788,1050,16890
"2630",2017,"South Dakota",2371,2803,303,266,5743
"2631",2017,"Tennessee",23009,13583,1109,0,37701
"2632",2017,"Texas",42697,31314,3040,4352,81403
"2633",2017,"Utah",3031,2961,233,0,6225
"2634",2017,"Vermont",1338,1214,74,120,2746
"2635",2017,"Virgin Islands",17,9,0,2,28
"2636",2017,"Virginia",21375,14319,820,0,36514
"2637",2017,"Washington",15595,9913,1897,1050,28455
"2638",2017,"West Virginia",5837,4995,272,688,11792
"2639",2017,"Wisconsin",12346,8888,758,58,22050
"2640",2017,"Wyoming",1329,1433,109,146,3017
"2641",2016,"Alabama",13733,17519,376,1066,32694
"2642",2016,"Alaska",4087,3698,243,382,8410
"2643",2016,"Arizona",18024,13785,1180,1406,34395
"2644",2016,"Arkansas",9192,13433,277,770,23672
"2645",2016,"California",63649,93224,77929,0,234802
"2646",2016,"Colorado",25905,21134,1428,2852,51319
"2647",2016,"Connecticut",8003,3153,119,0,11275
"2648",2016,"Delaware",2689,2981,126,234,6030
"2649",2016,"District of Columbia",60,5,0,4,69
"2650",2016,"Florida",69842,39880,3488,5190,118400
"2651",2016,"Georgia",23875,22613,598,1688,48774
"2652",2016,"Guam",105,51,8,16,180
"2653",2016,"Hawaii",0,0,0,0,0
"2654",2016,"Idaho",5471,7074,206,420,13171
"2655",2016,"Illinois",29658,17164,0,2062,48884
"2656",2016,"Indiana",30248,21688,1546,1822,55304
"2657",2016,"Iowa",391,4822,22,6,5241
"2658",2016,"Kansas",8494,10473,450,830,20247
"2659",2016,"Kentucky",17311,16766,371,1346,35794
"2660",2016,"Louisiana",18412,22848,992,1802,44054
"2661",2016,"Maine",4641,4713,322,374,10050
"2662",2016,"Mariana Islands",0,0,0,0,0
"2663",2016,"Maryland",4925,8870,211,66,14072
"2664",2016,"Massachusetts",7050,3884,392,394,11720
"2665",2016,"Michigan",14879,14328,550,490,30247
"2666",2016,"Minnesota",12431,12851,930,852,27064
"2667",2016,"Mississippi",13168,17231,366,1058,31823
"2668",2016,"Missouri",29770,27013,1507,2468,60758
"2669",2016,"Montana",3822,5832,164,440,10258
"2670",2016,"Nebraska",268,3697,27,12,4004
"2671",2016,"Nevada",6783,4696,313,822,12614
"2672",2016,"New Hampshire",6625,4225,183,2,11035
"2673",2016,"New Jersey",5394,4979,204,0,10577
"2674",2016,"New Mexico",7484,7149,467,662,15762
"2675",2016,"New York",12074,22585,1029,496,36184
"2676",2016,"North Carolina",2163,28023,907,570,31663
"2677",2016,"North Dakota",1799,2927,108,162,4996
"2678",2016,"Ohio",40996,29641,1877,3062,75576
"2679",2016,"Oklahoma",17990,19418,1126,2120,40654
"2680",2016,"Oregon",18931,16010,0,0,34941
"2681",2016,"Pennsylvania",64220,18688,40,0,82948
"2682",2016,"Puerto Rico",1334,256,37,56,1683
"2683",2016,"Rhode Island",1283,953,72,420,2728
"2684",2016,"South Carolina",15600,14782,809,850,32041
"2685",2016,"South Dakota",3525,5131,299,440,9395
"2686",2016,"Tennessee",36917,30997,1807,0,69721
"2687",2016,"Texas",69163,69272,3641,6416,148492
"2688",2016,"Utah",6428,9257,341,0,16026
"2689",2016,"Vermont",1802,1998,99,148,4047
"2690",2016,"Virgin Islands",15,5,0,0,20
"2691",2016,"Virginia",32572,27619,1308,0,61499
"2692",2016,"Washington",21835,16484,1949,1412,41680
"2693",2016,"West Virginia",10869,11628,338,1086,23921
"2694",2016,"Wisconsin",16521,15036,818,74,32449
"2695",2016,"Wyoming",2540,2984,110,238,5872
"2696",2016,"Alabama",10214,13470,388,1198,25270
"2697",2016,"Alaska",3396,4019,316,498,8229
"2698",2016,"Arizona",14850,11994,1288,1658,29790
"2699",2016,"Arkansas",7226,11866,268,898,20258
"2700",2016,"California",56932,82554,30133,0,169619
"2701",2016,"Colorado",24052,19794,1658,3106,48610
"2702",2016,"Connecticut",7063,3258,135,0,10456
"2703",2016,"Delaware",2490,2751,124,212,5577
"2704",2016,"District of Columbia",49,5,0,2,56
"2705",2016,"Florida",62351,35718,3676,5402,107147
"2706",2016,"Georgia",18011,16759,556,1606,36932
"2707",2016,"Guam",104,54,14,8,180
"2708",2016,"Hawaii",0,0,0,0,0
"2709",2016,"Idaho",4711,6175,325,464,11675
"2710",2016,"Illinois",28463,19005,0,2412,49880
"2711",2016,"Indiana",25246,23336,1521,1824,51927
"2712",2016,"Iowa",399,5112,38,26,5575
"2713",2016,"Kansas",8136,9854,537,986,19513
"2714",2016,"Kentucky",12847,14844,329,1280,29300
"2715",2016,"Louisiana",14674,18349,938,1700,35661
"2716",2016,"Maine",4135,5097,283,392,9907
"2717",2016,"Mariana Islands",0,4,0,0,4
"2718",2016,"Maryland",5356,9509,220,76,15161
"2719",2016,"Massachusetts",7117,4783,350,394,12644
"2720",2016,"Michigan",15803,18241,656,666,35366
"2721",2016,"Minnesota",12338,15597,907,888,29730
"2722",2016,"Mississippi",9382,13481,356,1056,24275
"2723",2016,"Missouri",23719,26338,1473,2594,54124
"2724",2016,"Montana",3093,5546,233,462,9334
"2725",2016,"Nebraska",216,3688,22,24,3950
"2726",2016,"Nevada",6338,4291,352,872,11853
"2727",2016,"New Hampshire",6283,4822,237,8,11350
"2728",2016,"New Jersey",5398,5720,199,0,11317
"2729",2016,"New Mexico",6153,6034,490,712,13389
"2730",2016,"New York",11157,25229,1245,496,38127
"2731",2016,"North Carolina",1709,23215,939,524,26387
"2732",2016,"North Dakota",1827,3546,104,196,5673
"2733",2016,"Ohio",37304,32312,1977,3388,74981
"2734",2016,"Oklahoma",16348,17019,1274,2176,36817
"2735",2016,"Oregon",17013,15711,0,0,32724
"2736",2016,"Pennsylvania",66188,20487,42,0,86717
"2737",2016,"Puerto Rico",1323,204,26,68,1621
"2738",2016,"Rhode Island",1271,1065,94,402,2832
"2739",2016,"South Carolina",12839,11547,616,1116,26118
"2740",2016,"South Dakota",3456,5677,374,418,9925
"2741",2016,"Tennessee",29502,25976,1719,0,57197
"2742",2016,"Texas",58778,56057,3610,7520,125965
"2743",2016,"Utah",5232,7021,374,0,12627
"2744",2016,"Vermont",1342,1975,109,146,3572
"2745",2016,"Virgin Islands",17,5,0,0,22
"2746",2016,"Virginia",29544,26823,1298,0,57665
"2747",2016,"Washington",19534,16266,2243,1616,39659
"2748",2016,"West Virginia",7824,11134,333,930,20221
"2749",2016,"Wisconsin",17580,19631,883,68,38162
"2750",2016,"Wyoming",2097,2691,136,250,5174
"2751",2016,"Alabama",7757,8865,403,858,17883
"2752",2016,"Alaska",3906,3949,347,548,8750
"2753",2016,"Arizona",12405,9382,1224,1362,24373
"2754",2016,"Arkansas",5607,8235,309,746,14897
"2755",2016,"California",45785,54333,19226,0,119344
"2756",2016,"Colorado",20343,16962,1701,2658,41664
"2757",2016,"Connecticut",6374,2698,148,0,9220
"2758",2016,"Delaware",2070,2082,119,214,4485
"2759",2016,"District of Columbia",59,2,0,0,61
"2760",2016,"Florida",50003,27010,3908,4604,85525
"2761",2016,"Georgia",13799,12262,592,1328,27981
"2762",2016,"Guam",127,72,17,8,224
"2763",2016,"Hawaii",0,0,0,0,0
"2764",2016,"Idaho",3913,5787,270,416,10386
"2765",2016,"Illinois",33986,14739,0,2180,50905
"2766",2016,"Indiana",21058,16857,1725,1658,41298
"2767",2016,"Iowa",221,3557,25,22,3825
"2768",2016,"Kansas",6527,6775,534,836,14672
"2769",2016,"Kentucky",10111,10030,354,1038,21533
"2770",2016,"Louisiana",11865,13673,1043,1358,27939
"2771",2016,"Maine",4320,6926,319,870,12435
"2772",2016,"Mariana Islands",0,1,0,0,1
"2773",2016,"Maryland",4280,6786,180,64,11310
"2774",2016,"Massachusetts",6415,3680,344,396,10835
"2775",2016,"Michigan",12680,13539,618,574,27411
"2776",2016,"Minnesota",11394,18553,1024,1022,31993
"2777",2016,"Mississippi",7564,8323,350,812,17049
"2778",2016,"Missouri",21994,20919,1633,2392,46938
"2779",2016,"Montana",3035,6689,213,542,10479
"2780",2016,"Nebraska",144,2817,24,16,3001
"2781",2016,"Nevada",5614,3471,350,756,10191
"2782",2016,"New Hampshire",5968,4672,258,8,10906
"2783",2016,"New Jersey",5391,4567,217,0,10175
"2784",2016,"New Mexico",5449,4826,470,564,11309
"2785",2016,"New York",10820,21094,1117,438,33469
"2786",2016,"North Carolina",1353,15980,1042,434,18809
"2787",2016,"North Dakota",1674,4451,125,226,6476
"2788",2016,"Ohio",30593,21991,2592,3042,58218
"2789",2016,"Oklahoma",11560,11325,1127,1704,25716
"2790",2016,"Oregon",14749,13412,0,0,28161
"2791",2016,"Pennsylvania",56836,16223,40,0,73099
"2792",2016,"Puerto Rico",1165,194,40,50,1449
"2793",2016,"Rhode Island",1162,950,94,428,2634
"2794",2016,"South Carolina",9270,7797,598,792,18457
"2795",2016,"South Dakota",3127,6859,368,484,10838
"2796",2016,"Tennessee",23542,18514,1485,148,43689
"2797",2016,"Texas",46518,44519,3763,5802,100602
"2798",2016,"Utah",3588,4603,345,0,8536
"2799",2016,"Vermont",1485,2099,99,168,3851
"2800",2016,"Virgin Islands",16,13,0,0,29
"2801",2016,"Virginia",24337,20433,1269,0,46039
"2802",2016,"Washington",18601,15455,2650,1490,38196
"2803",2016,"West Virginia",6721,7737,353,810,15621
"2804",2016,"Wisconsin",15514,17376,946,104,33940
"2805",2016,"Wyoming",1709,2307,127,232,4375
"2806",2016,"Alabama",7125,8449,319,744,16637
"2807",2016,"Alaska",2654,3126,180,362,6322
"2808",2016,"Arizona",11769,8951,1086,1278,23084
"2809",2016,"Arkansas",4802,6284,231,648,11965
"2810",2016,"California",39213,43015,13548,0,95776
"2811",2016,"Colorado",17390,14521,1143,2272,35326
"2812",2016,"Connecticut",5424,2472,104,0,8000
"2813",2016,"Delaware",1759,1894,76,168,3897
"2814",2016,"District of Columbia",46,4,0,4,54
"2815",2016,"Florida",45848,22439,3359,3782,75428
"2816",2016,"Georgia",12258,9766,456,1026,23506
"2817",2016,"Guam",99,63,25,4,191
"2818",2016,"Hawaii",0,0,0,0,0
"2819",2016,"Idaho",3124,5230,234,422,9010
"2820",2016,"Illinois",20298,11876,0,1546,33720
"2821",2016,"Indiana",17402,13402,1291,1272,33367
"2822",2016,"Iowa",154,2694,26,16,2890
"2823",2016,"Kansas",4903,5614,371,576,11464
"2824",2016,"Kentucky",8917,8172,257,1180,18526
"2825",2016,"Louisiana",12875,13747,768,1580,28970
"2826",2016,"Maine",3841,5203,222,596,9862
"2827",2016,"Mariana Islands",0,1,0,0,1
"2828",2016,"Maryland",3626,5428,135,40,9229
"2829",2016,"Massachusetts",5584,3210,327,300,9421
"2830",2016,"Michigan",10056,11311,477,470,22314
"2831",2016,"Minnesota",9548,16213,695,826,27282
"2832",2016,"Mississippi",6904,6592,276,754,14526
"2833",2016,"Missouri",17808,15528,1323,1898,36557
"2834",2016,"Montana",2702,5404,167,454,8727
"2835",2016,"Nebraska",104,2144,19,8,2275
"2836",2016,"Nevada",4281,2764,262,544,7851
"2837",2016,"New Hampshire",5100,3766,184,8,9058
"2838",2016,"New Jersey",5249,3864,196,0,9309
"2839",2016,"New Mexico",4793,4277,368,572,10010
"2840",2016,"New York",9700,17804,884,416,28804
"2841",2016,"North Carolina",1068,14018,722,490,16298
"2842",2016,"North Dakota",1273,3381,99,168,4921
"2843",2016,"Ohio",24297,18038,1573,2242,46150
"2844",2016,"Oklahoma",9638,10003,860,1638,22139
"2845",2016,"Oregon",13325,13046,0,0,26371
"2846",2016,"Pennsylvania",46101,12697,31,0,58829
"2847",2016,"Puerto Rico",1110,213,28,48,1399
"2848",2016,"Rhode Island",1031,767,62,336,2196
"2849",2016,"South Carolina",8725,7088,483,704,17000
"2850",2016,"South Dakota",2530,4663,178,358,7729
"2851",2016,"Tennessee",20721,15120,0,2282,38123
"2852",2016,"Texas",37858,42308,2888,4872,87926
"2853",2016,"Utah",2918,4440,278,0,7636
"2854",2016,"Vermont",1233,1701,96,192,3222
"2855",2016,"Virgin Islands",25,7,0,2,34
"2856",2016,"Virginia",20325,16687,954,0,37966
"2857",2016,"Washington",15261,13621,2203,1368,32453
"2858",2016,"West Virginia",6122,6495,256,872,13745
"2859",2016,"Wisconsin",13271,14796,691,66,28824
"2860",2016,"Wyoming",1521,2207,90,196,4014
"2861",2016,"Alabama",8243,7808,352,768,17171
"2862",2016,"Alaska",2725,3484,183,404,6796
"2863",2016,"Arizona",12069,8601,1084,1234,22988
"2864",2016,"Arkansas",5666,6108,207,666,12647
"2865",2016,"California",43344,43552,13186,0,100082
"2866",2016,"Colorado",18116,14054,1204,2156,35530
"2867",2016,"Connecticut",9929,3941,230,0,14100
"2868",2016,"Delaware",1662,1562,96,160,3480
"2869",2016,"District of Columbia",56,3,0,2,61
"2870",2016,"Florida",49867,23359,3572,3754,80552
"2871",2016,"Georgia",12627,9187,556,1026,23396
"2872",2016,"Guam",95,54,16,10,175
"2873",2016,"Hawaii",0,0,0,0,0
"2874",2016,"Idaho",3194,4214,177,374,7959
"2875",2016,"Illinois",60745,30602,0,3926,95273
"2876",2016,"Indiana",18906,13606,1238,1192,34942
"2877",2016,"Iowa",182,2345,22,6,2555
"2878",2016,"Kansas",4987,5437,404,566,11394
"2879",2016,"Kentucky",8842,7187,281,890,17200
"2880",2016,"Louisiana",13082,10527,971,1690,26270
"2881",2016,"Maine",3294,3546,239,344,7423
"2882",2016,"Mariana Islands",0,2,1,0,3
"2883",2016,"Maryland",4249,5109,89,46,9493
"2884",2016,"Massachusetts",5601,2915,340,380,9236
"2885",2016,"Michigan",10650,9117,458,404,20629
"2886",2016,"Minnesota",9391,11884,694,762,22731
"2887",2016,"Mississippi",11193,9085,412,1200,21890
"2888",2016,"Missouri",18394,15365,1418,1906,37083
"2889",2016,"Montana",2882,4487,162,448,7979
"2890",2016,"Nebraska",126,1805,19,4,1954
"2891",2016,"Nevada",4676,2629,246,548,8099
"2892",2016,"New Hampshire",4732,3421,182,16,8351
"2893",2016,"New Jersey",5541,3962,225,0,9728
"2894",2016,"New Mexico",5170,4224,316,642,10352
"2895",2016,"New York",10716,14278,961,374,26329
"2896",2016,"North Carolina",1208,12513,755,360,14836
"2897",2016,"North Dakota",1284,2601,92,138,4115
"2898",2016,"Ohio",26261,17526,1626,2320,47733
"2899",2016,"Oklahoma",10881,9762,1008,1576,23227
"2900",2016,"Oregon",12661,10173,0,0,22834
"2901",2016,"Pennsylvania",46155,11700,4,0,57859
"2902",2016,"Puerto Rico",1073,234,21,48,1376
"2903",2016,"Rhode Island",1039,770,104,290,2203
"2904",2016,"South Carolina",8828,6906,494,660,16888
"2905",2016,"South Dakota",2387,3559,202,266,6414
"2906",2016,"Tennessee",22737,16198,0,2380,41315
"2907",2016,"Texas",42302,40269,3137,4694,90402
"2908",2016,"Utah",2917,3503,277,0,6697
"2909",2016,"Vermont",1269,1296,108,94,2767
"2910",2016,"Virgin Islands",29,6,0,0,35
"2911",2016,"Virginia",21108,15802,978,0,37888
"2912",2016,"Washington",15083,11376,1622,1212,29293
"2913",2016,"West Virginia",6916,5283,243,690,13132
"2914",2016,"Wisconsin",14764,12079,709,86,27638
"2915",2016,"Wyoming",1721,2079,105,192,4097
"2916",2016,"Alabama",10132,7392,538,930,18992
"2917",2016,"Alaska",2898,2816,239,330,6283
"2918",2016,"Arizona",13693,8643,1283,1284,24903
"2919",2016,"Arkansas",6323,5053,325,734,12435
"2920",2016,"California",46361,47594,17297,0,111252
"2921",2016,"Colorado",18765,15176,1505,2108,37554
"2922",2016,"Connecticut",11328,4015,252,0,15595
"2923",2016,"Delaware",1859,1569,140,148,3716
"2924",2016,"District of Columbia",57,1,0,4,62
"2925",2016,"Florida",57902,28000,4504,4648,95054
"2926",2016,"Georgia",15342,8597,635,1264,25838
"2927",2016,"Guam",94,56,16,14,180
"2928",2016,"Hawaii",0,0,0,0,0
"2929",2016,"Idaho",3592,3576,247,406,7821
"2930",2016,"Illinois",21421,11881,0,1762,35064
"2931",2016,"Indiana",19508,12191,1600,1288,34587
"2932",2016,"Iowa",186,2227,27,2,2442
"2933",2016,"Kansas",6075,4942,462,658,12137
"2934",2016,"Kentucky",9378,6615,321,1068,17382
"2935",2016,"Louisiana",21637,12252,1453,2062,37404
"2936",2016,"Maine",3426,3026,266,332,7050
"2937",2016,"Mariana Islands",0,1,0,0,1
"2938",2016,"Maryland",3973,5505,105,70,9653
"2939",2016,"Massachusetts",6257,5108,1498,878,13741
"2940",2016,"Michigan",11308,8095,510,478,20391
"2941",2016,"Minnesota",9743,9207,913,746,20609
"2942",2016,"Mississippi",10425,6125,436,918,17904
"2943",2016,"Missouri",20791,13575,1698,1962,38026
"2944",2016,"Montana",2894,3882,218,388,7382
"2945",2016,"Nebraska",93,1529,27,10,1659
"2946",2016,"Nevada",5194,3006,328,616,9144
"2947",2016,"New Hampshire",5200,3716,181,6,9103
"2948",2016,"New Jersey",5708,4155,211,0,10074
"2949",2016,"New Mexico",5380,3966,475,600,10421
"2950",2016,"New York",10900,13073,1131,408,25512
"2951",2016,"North Carolina",1157,12487,1025,430,15099
"2952",2016,"North Dakota",1333,2457,116,128,4034
"2953",2016,"Ohio",27876,17720,2166,2464,50226
"2954",2016,"Oklahoma",11750,8792,1139,1504,23185
"2955",2016,"Oregon",14284,10507,0,0,24791
"2956",2016,"Pennsylvania",46843,11793,19,0,58655
"2957",2016,"Puerto Rico",1038,234,31,40,1343
"2958",2016,"Rhode Island",1133,951,101,310,2495
"2959",2016,"South Carolina",9967,5880,707,722,17276
"2960",2016,"South Dakota",2490,3004,277,270,6041
"2961",2016,"Tennessee",26276,16118,0,2748,45142
"2962",2016,"Texas",50499,34266,4046,5396,94207
"2963",2016,"Utah",3381,3328,276,204,7189
"2964",2016,"Vermont",1293,1201,117,114,2725
"2965",2016,"Virgin Islands",21,2,0,2,25
"2966",2016,"Virginia",24671,16731,1064,0,42466
"2967",2016,"Washington",15652,11536,2118,1306,30612
"2968",2016,"West Virginia",6417,5134,313,806,12670
"2969",2016,"Wisconsin",13182,9870,847,76,23975
"2970",2016,"Wyoming",1619,1769,131,198,3717
"2971",2016,"Alabama",9146,7273,555,862,17836
"2972",2016,"Alaska",2987,3204,286,370,6847
"2973",2016,"Arizona",12942,8614,1345,1370,24271
"2974",2016,"Arkansas",5454,4574,330,666,11024
"2975",2016,"California",43042,37512,10673,0,91227
"2976",2016,"Colorado",17790,15115,1676,2122,36703
"2977",2016,"Connecticut",12011,3974,307,0,16292
"2978",2016,"Delaware",1842,1621,125,186,3774
"2979",2016,"District of Columbia",46,3,0,0,49
"2980",2016,"Florida",55934,29501,5096,4856,95387
"2981",2016,"Georgia",13307,7859,649,1100,22915
"2982",2016,"Guam",104,50,7,6,167
"2983",2016,"Hawaii",0,0,0,0,0
"2984",2016,"Idaho",3445,4143,282,384,8254
"2985",2016,"Illinois",22277,12787,0,1782,36846
"2986",2016,"Indiana",18307,11949,1831,1348,33435
"2987",2016,"Iowa",129,2004,76,16,2225
"2988",2016,"Kansas",5275,4447,523,612,10857
"2989",2016,"Kentucky",8703,6584,438,998,16723
"2990",2016,"Louisiana",12082,8428,1161,1192,22863
"2991",2016,"Maine",3433,2943,301,366,7043
"2992",2016,"Mariana Islands",0,1,0,0,1
"2993",2016,"Maryland",4288,4864,138,98,9388
"2994",2016,"Massachusetts",5965,3404,990,482,10841
"2995",2016,"Michigan",10335,8282,616,454,19687
"2996",2016,"Minnesota",8880,9723,1215,866,20684
"2997",2016,"Mississippi",7804,4692,346,738,13580
"2998",2016,"Missouri",18770,13295,1813,1916,35794
"2999",2016,"Montana",2968,4379,234,342,7923
"3000",2016,"Nebraska",107,1609,15,12,1743
"3001",2016,"Nevada",4949,3114,358,558,8979
"3002",2016,"New Hampshire",5166,3453,196,12,8827
"3003",2016,"New Jersey",6266,4294,246,0,10806
"3004",2016,"New Mexico",5336,4231,531,600,10698
"3005",2016,"New York",10062,12213,1205,400,23880
"3006",2016,"North Carolina",1181,11749,943,446,14319
"3007",2016,"North Dakota",1312,2377,164,128,3981
"3008",2016,"Ohio",24397,17086,2294,2406,46183
"3009",2016,"Oklahoma",11933,8811,1415,1604,23763
"3010",2016,"Oregon",14054,11400,0,0,25454
"3011",2016,"Pennsylvania",44677,11841,35,0,56553
"3012",2016,"Puerto Rico",1025,214,36,36,1311
"3013",2016,"Rhode Island",1146,862,85,346,2439
"3014",2016,"South Carolina",9619,5599,680,696,16594
"3015",2016,"South Dakota",2460,3139,309,286,6194
"3016",2016,"Tennessee",22476,15194,0,2930,40600
"3017",2016,"Texas",46816,33501,4013,5018,89348
"3018",2016,"Utah",3433,3731,311,372,7847
"3019",2016,"Vermont",1240,1225,131,170,2766
"3020",2016,"Virgin Islands",24,7,0,2,33
"3021",2016,"Virginia",20132,15480,993,0,36605
"3022",2016,"Washington",17040,13267,2576,1422,34305
"3023",2016,"West Virginia",6602,4821,375,784,12582
"3024",2016,"Wisconsin",12464,11144,1173,140,24921
"3025",2016,"Wyoming",1638,2110,123,208,4079
"3026",2016,"Alabama",7903,5256,254,588,14001
"3027",2016,"Alaska",2582,2391,190,320,5483
"3028",2016,"Arizona",10994,6539,880,1058,19471
"3029",2016,"Arkansas",4551,3596,137,448,8732
"3030",2016,"California",38301,28723,6124,0,73148
"3031",2016,"Colorado",16293,11252,934,1842,30321
"3032",2016,"Connecticut",9953,3362,212,0,13527
"3033",2016,"Delaware",1722,1121,66,114,3023
"3034",2016,"District of Columbia",47,6,0,0,53
"3035",2016,"Florida",42845,17025,2625,3012,65507
"3036",2016,"Georgia",10866,5510,361,840,17577
"3037",2016,"Guam",119,56,8,20,203
"3038",2016,"Hawaii",0,0,0,0,0
"3039",2016,"Idaho",3132,3323,149,334,6938
"3040",2016,"Illinois",19264,8686,0,1196,29146
"3041",2016,"Indiana",16842,9264,965,1086,28157
"3042",2016,"Iowa",121,1569,16,6,1712
"3043",2016,"Kansas",4648,3553,281,526,9008
"3044",2016,"Kentucky",8049,5244,222,828,14343
"3045",2016,"Louisiana",9561,5788,668,812,16829
"3046",2016,"Maine",3009,2464,142,282,5897
"3047",2016,"Mariana Islands",0,1,0,0,1
"3048",2016,"Maryland",4099,4148,130,42,8419
"3049",2016,"Massachusetts",5278,2325,486,316,8405
"3050",2016,"Michigan",9834,6490,344,324,16992
"3051",2016,"Minnesota",8772,7638,637,680,17727
"3052",2016,"Mississippi",7005,3541,215,634,11395
"3053",2016,"Missouri",16909,10162,966,1648,29685
"3054",2016,"Montana",2724,3881,123,350,7078
"3055",2016,"Nebraska",78,1277,9,10,1374
"3056",2016,"Nevada",4365,2329,191,450,7335
"3057",2016,"New Hampshire",4262,2645,137,10,7054
"3058",2016,"New Jersey",6542,3027,201,0,9770
"3059",2016,"New Mexico",4485,3269,327,448,8529
"3060",2016,"New York",10118,10815,684,302,21919
"3061",2016,"North Carolina",1119,8506,518,338,10481
"3062",2016,"North Dakota",1186,1798,85,96,3165
"3063",2016,"Ohio",26069,13219,1435,1946,42669
"3064",2016,"Oklahoma",10385,6490,779,1372,19026
"3065",2016,"Oregon",12038,9194,0,0,21232
"3066",2016,"Pennsylvania",39963,8770,23,0,48756
"3067",2016,"Puerto Rico",991,166,24,40,1221
"3068",2016,"Rhode Island",936,536,28,226,1726
"3069",2016,"South Carolina",7570,3922,363,482,12337
"3070",2016,"South Dakota",2161,2666,191,302,5320
"3071",2016,"Tennessee",19232,10394,0,1882,31508
"3072",2016,"Texas",39446,25424,2559,3838,71267
"3073",2016,"Utah",3097,3067,235,324,6723
"3074",2016,"Vermont",1096,1026,62,116,2300
"3075",2016,"Virgin Islands",26,2,0,0,28
"3076",2016,"Virginia",18183,10896,758,0,29837
"3077",2016,"Washington",14601,9033,1334,1008,25976
"3078",2016,"West Virginia",6099,4179,232,700,11210
"3079",2016,"Wisconsin",11438,8481,562,78,20559
"3080",2016,"Wyoming",1497,1671,97,178,3443
"3081",2016,"Alabama",9742,6977,320,824,17863
"3082",2016,"Alaska",3036,2777,178,352,6343
"3083",2016,"Arizona",13086,7278,885,1076,22325
"3084",2016,"Arkansas",5334,4513,193,562,10602
"3085",2016,"California",41862,30133,5247,0,77242
"3086",2016,"Colorado",17897,12560,1048,2010,33515
"3087",2016,"Connecticut",11882,3936,229,0,16047
"3088",2016,"Delaware",1878,1313,72,124,3387
"3089",2016,"District of Columbia",55,3,0,0,58
"3090",2016,"Florida",48697,19716,2788,3192,74393
"3091",2016,"Georgia",13673,6764,385,886,21708
"3092",2016,"Guam",100,45,8,14,167
"3093",2016,"Hawaii",0,0,0,0,0
"3094",2016,"Idaho",3376,3720,179,314,7589
"3095",2016,"Illinois",24894,11132,0,1740,37766
"3096",2016,"Indiana",20756,12137,1079,1274,35246
"3097",2016,"Iowa",184,2453,27,4,2668
"3098",2016,"Kansas",5785,4540,333,548,11206
"3099",2016,"Kentucky",9657,7070,223,962,17912
"3100",2016,"Louisiana",11703,6552,685,1088,20028
"3101",2016,"Maine",3970,3254,184,356,7764
"3102",2016,"Mariana Islands",0,0,0,0,0
"3103",2016,"Maryland",4294,4966,145,38,9443
"3104",2016,"Massachusetts",6227,3009,594,332,10162
"3105",2016,"Michigan",13598,8647,445,378,23068
"3106",2016,"Minnesota",12547,12295,809,938,26589
"3107",2016,"Mississippi",8765,4139,263,682,13849
"3108",2016,"Missouri",19787,12754,970,1792,35303
"3109",2016,"Montana",2989,4388,133,402,7912
"3110",2016,"Nebraska",116,1650,18,10,1794
"3111",2016,"Nevada",5135,2793,223,510,8661
"3112",2016,"New Hampshire",5337,3400,139,8,8884
"3113",2016,"New Jersey",6887,3331,247,0,10465
"3114",2016,"New Mexico",5311,3967,294,472,10044
"3115",2016,"New York",11281,14660,881,410,27232
"3116",2016,"North Carolina",1250,10280,607,418,12555
"3117",2016,"North Dakota",2083,2791,89,226,5189
"3118",2016,"Ohio",32959,17664,1618,2488,54729
"3119",2016,"Oklahoma",13132,8302,915,1622,23971
"3120",2016,"Oregon",13102,9998,0,0,23100
"3121",2016,"Pennsylvania",51472,11628,15,0,63115
"3122",2016,"Puerto Rico",947,202,17,34,1200
"3123",2016,"Rhode Island",1149,746,35,276,2206
"3124",2016,"South Carolina",9617,4618,391,540,15166
"3125",2016,"South Dakota",2981,3412,218,350,6961
"3126",2016,"Tennessee",22965,12049,0,1982,36996
"3127",2016,"Texas",45339,27823,2775,4578,80515
"3128",2016,"Utah",3560,3646,230,322,7758
"3129",2016,"Vermont",1483,1557,90,164,3294
"3130",2016,"Virgin Islands",23,3,0,0,26
"3131",2016,"Virginia",21709,13235,851,0,35795
"3132",2016,"Washington",15988,9698,1415,1076,28177
"3133",2016,"West Virginia",6908,5417,249,736,13310
"3134",2016,"Wisconsin",15693,13348,673,76,29790
"3135",2016,"Wyoming",1764,1952,104,184,4004
"3136",2016,"Alabama",14372,9115,383,1160,25030
"3137",2016,"Alaska",3171,2750,209,378,6508
"3138",2016,"Arizona",14387,7907,883,1228,24405
"3139",2016,"Arkansas",7603,5448,219,706,13976
"3140",2016,"California",45266,31454,6007,0,82727
"3141",2016,"Colorado",20049,12776,1069,2384,36278
"3142",2016,"Connecticut",13996,4388,198,0,18582
"3143",2016,"Delaware",2353,1611,83,174,4221
"3144",2016,"District of Columbia",74,6,0,0,80
"3145",2016,"Florida",54164,22000,2874,3496,82534
"3146",2016,"Georgia",18272,8517,467,1080,28336
"3147",2016,"Guam",115,58,8,14,195
"3148",2016,"Hawaii",0,0,0,0,0
"3149",2016,"Idaho",3925,4208,227,412,8772
"3150",2016,"Illinois",29052,12971,0,1964,43987
"3151",2016,"Indiana",27883,13485,1472,1652,44492
"3152",2016,"Iowa",252,3012,25,4,3293
"3153",2016,"Kansas",7683,5368,409,592,14052
"3154",2016,"Kentucky",13816,8391,283,1190,23680
"3155",2016,"Louisiana",13738,7553,799,1104,23194
"3156",2016,"Maine",4725,3320,232,378,8655
"3157",2016,"Mariana Islands",0,1,0,0,1
"3158",2016,"Maryland",4866,5363,157,26,10412
"3159",2016,"Massachusetts",7019,3275,546,348,11188
"3160",2016,"Michigan",18316,10145,495,446,29402
"3161",2016,"Minnesota",13738,11323,797,884,26742
"3162",2016,"Mississippi",11287,5697,331,738,18053
"3163",2016,"Missouri",27030,15359,1257,2110,45756
"3164",2016,"Montana",3305,4621,150,468,8544
"3165",2016,"Nebraska",132,1944,16,10,2102
"3166",2016,"Nevada",6116,3062,231,590,9999
"3167",2016,"New Hampshire",5912,3506,142,14,9574
"3168",2016,"New Jersey",7346,3582,210,0,11138
"3169",2016,"New Mexico",6497,4466,388,604,11955
"3170",2016,"New York",12474,15134,1041,386,29035
"3171",2016,"North Carolina",1494,12263,673,394,14824
"3172",2016,"North Dakota",1945,2711,97,144,4897
"3173",2016,"Ohio",40331,19408,2179,2918,64836
"3174",2016,"Oklahoma",14892,8975,958,1648,26473
"3175",2016,"Oregon",15513,11510,0,0,27023
"3176",2016,"Pennsylvania",60489,12299,0,0,72788
"3177",2016,"Puerto Rico",948,200,8,44,1200
"3178",2016,"Rhode Island",1411,858,57,306,2632
"3179",2016,"South Carolina",12312,6138,446,690,19586
"3180",2016,"South Dakota",3451,3588,236,348,7623
"3181",2016,"Tennessee",27951,14909,0,2198,45058
"3182",2016,"Texas",55547,31794,2985,4888,95214
"3183",2016,"Utah",3772,3883,262,372,8289
"3184",2016,"Vermont",1941,1715,118,156,3930
"3185",2016,"Virgin Islands",19,3,0,2,24
"3186",2016,"Virginia",26264,14622,1019,0,41905
"3187",2016,"Washington",19501,10947,1643,1230,33321
"3188",2016,"West Virginia",9481,6336,273,940,17030
"3189",2016,"Wisconsin",18439,14836,807,70,34152
"3190",2016,"Wyoming",1995,2026,135,206,4362
"3191",2016,"Alabama",29311,15054,950,2324,47639
"3192",2016,"Alaska",3190,2428,218,360,6196
"3193",2016,"Arizona",16820,8782,877,1712,28191
"3194",2016,"Arkansas",10532,7028,258,1276,19094
"3195",2016,"California",44461,29486,5283,0,79230
"3196",2016,"Colorado",22384,13355,1050,2604,39393
"3197",2016,"Connecticut",13316,4250,275,0,17841
"3198",2016,"Delaware",2702,1633,131,188,4654
"3199",2016,"District of Columbia",74,7,0,0,81
"3200",2016,"Florida",62770,25228,3069,4276,95343
"3201",2016,"Georgia",24534,10747,565,1984,37830
"3202",2016,"Guam",85,44,8,8,145
"3203",2016,"Hawaii",0,0,0,0,0
"3204",2016,"Idaho",4419,4321,242,554,9536
"3205",2016,"Illinois",30241,13543,0,2070,45854
"3206",2016,"Indiana",32373,14947,1625,1870,50815
"3207",2016,"Iowa",279,2859,45,14,3197
"3208",2016,"Kansas",9407,6165,433,1050,17055
"3209",2016,"Kentucky",19243,10414,404,2274,32335
"3210",2016,"Louisiana",16474,9031,888,1546,27939
"3211",2016,"Maine",5426,3234,228,322,9210
"3212",2016,"Mariana Islands",0,1,0,0,1
"3213",2016,"Maryland",4368,5803,163,76,10410
"3214",2016,"Massachusetts",6253,2838,562,338,9991
"3215",2016,"Michigan",19778,10899,543,516,31736
"3216",2016,"Minnesota",12754,9635,793,800,23982
"3217",2016,"Mississippi",15296,7203,308,1206,24013
"3218",2016,"Missouri",30802,16707,1404,2910,51823
"3219",2016,"Montana",3779,4151,154,650,8734
"3220",2016,"Nebraska",154,2078,27,22,2281
"3221",2016,"Nevada",6643,3115,244,666,10668
"3222",2016,"New Hampshire",6798,3464,156,10,10428
"3223",2016,"New Jersey",6007,3613,191,0,9811
"3224",2016,"New Mexico",7455,5049,393,1012,13909
"3225",2016,"New York",11963,15324,1130,406,28823
"3226",2016,"North Carolina",1543,14935,835,864,18177
"3227",2016,"North Dakota",2100,2419,99,170,4788
"3228",2016,"Ohio",45459,20745,2196,3746,72146
"3229",2016,"Oklahoma",18984,10754,1184,2580,33502
"3230",2016,"Oregon",17116,11665,0,0,28781
"3231",2016,"Pennsylvania",61933,11791,0,0,73724
"3232",2016,"Puerto Rico",885,152,24,44,1105
"3233",2016,"Rhode Island",1288,848,64,304,2504
"3234",2016,"South Carolina",15746,6847,522,1076,24191
"3235",2016,"South Dakota",4170,4009,169,504,8852
"3236",2016,"Tennessee",36439,18121,0,3092,57652
"3237",2016,"Texas",72584,37980,3156,7782,121502
"3238",2016,"Utah",4413,4000,259,440,9112
"3239",2016,"Vermont",2273,1681,128,172,4254
"3240",2016,"Virgin Islands",25,4,0,0,29
"3241",2016,"Virginia",30085,15948,1133,0,47166
"3242",2016,"Washington",20583,11991,1832,1726,36132
"3243",2016,"West Virginia",10746,7436,357,1514,20053
"3244",2016,"Wisconsin",19465,12431,821,124,32841
"3245",2016,"Wyoming",2287,2036,139,300,4762
"3246",2016,"Alabama",25445,14785,1266,1768,43264
"3247",2016,"Alaska",2859,2245,300,328,5732
"3248",2016,"Arizona",15745,8512,1107,1150,26514
"3249",2016,"Arkansas",7954,5982,305,680,14921
"3250",2016,"California",52139,32970,7054,0,92163
"3251",2016,"Colorado",23518,13327,1474,2472,40791
"3252",2016,"Connecticut",13096,4366,236,0,17698
"3253",2016,"Delaware",2548,1608,110,146,4412
"3254",2016,"District of Columbia",52,3,0,0,55
"3255",2016,"Florida",62085,26356,3480,4072,95993
"3256",2016,"Georgia",18236,9696,654,1128,29714
"3257",2016,"Guam",102,57,11,12,182
"3258",2016,"Hawaii",0,0,0,0,0
"3259",2016,"Idaho",4221,3820,266,312,8619
"3260",2016,"Illinois",32112,12869,0,1626,46607
"3261",2016,"Indiana",29653,14356,1871,1878,47758
"3262",2016,"Iowa",292,2600,44,18,2954
"3263",2016,"Kansas",9196,6580,586,762,17124
"3264",2016,"Kentucky",13847,7713,403,832,22795
"3265",2016,"Louisiana",15485,10374,1054,1284,28197
"3266",2016,"Maine",4625,3054,294,304,8277
"3267",2016,"Mariana Islands",0,3,0,0,3
"3268",2016,"Maryland",3981,5541,116,32,9670
"3269",2016,"Massachusetts",7211,3500,667,402,11780
"3270",2016,"Michigan",17641,9995,670,430,28736
"3271",2016,"Minnesota",12426,8624,875,828,22753
"3272",2016,"Mississippi",10257,6713,422,730,18122
"3273",2016,"Missouri",28980,15693,1942,1910,48525
"3274",2016,"Montana",3354,3574,191,410,7529
"3275",2016,"Nebraska",179,2256,37,26,2498
"3276",2016,"Nevada",6064,2835,289,514,9702
"3277",2016,"New Hampshire",7146,3591,211,8,10956
"3278",2016,"New Jersey",4520,4005,158,0,8683
"3279",2016,"New Mexico",5921,4206,405,576,11108
"3280",2016,"New York",12020,15461,1192,400,29073
"3281",2016,"North Carolina",1350,12950,920,356,15576
"3282",2016,"North Dakota",2159,2554,106,162,4981
"3283",2016,"Ohio",38028,18613,2460,2644,61745
"3284",2016,"Oklahoma",18688,10863,1313,1778,32642
"3285",2016,"Oregon",15930,10403,0,0,26333
"3286",2016,"Pennsylvania",57355,10224,0,0,67579
"3287",2016,"Puerto Rico",940,147,16,42,1145
"3288",2016,"Rhode Island",1413,898,89,354,2754
"3289",2016,"South Carolina",12380,6289,669,652,19990
"3290",2016,"South Dakota",3782,3815,313,342,8252
"3291",2016,"Tennessee",30411,16571,0,2542,49524
"3292",2016,"Texas",72626,38396,3756,5400,120178
"3293",2016,"Utah",4662,3654,326,348,8990
"3294",2016,"Vermont",1863,1379,134,130,3506
"3295",2016,"Virgin Islands",26,0,0,2,28
"3296",2016,"Virginia",27033,15699,922,0,43654
"3297",2016,"Washington",20427,11355,2147,1190,35119
"3298",2016,"West Virginia",7419,5505,321,698,13943
"3299",2016,"Wisconsin",17969,10756,937,84,29746
"3300",2016,"Wyoming",2181,1983,160,208,4532
"3301",2015,"Alabama",47605,33710,1698,3504,86517
"3302",2015,"Alaska",5265,4638,356,428,10687
"3303",2015,"Arizona",25562,14725,1327,1990,43604
"3304",2015,"Arkansas",13780,15241,365,1042,30428
"3305",2015,"California",74399,48762,9583,0,132744
"3306",2015,"Colorado",34653,22880,1903,3300,62736
"3307",2015,"Connecticut",17828,6337,314,0,24479
"3308",2015,"Delaware",3615,3274,175,274,7338
"3309",2015,"District of Columbia",76,3,0,0,79
"3310",2015,"Florida",86940,45769,4165,6010,142884
"3311",2015,"Georgia",34974,25174,863,2436,63447
"3312",2015,"Guam",145,60,9,8,222
"3313",2015,"Hawaii",0,0,0,0,0
"3314",2015,"Idaho",7023,7813,320,552,15708
"3315",2015,"Illinois",37193,20864,0,2596,60653
"3316",2015,"Indiana",44150,26105,2370,2606,75231
"3317",2015,"Iowa",436,5654,51,16,6157
"3318",2015,"Kansas",12324,12127,605,1140,26196
"3319",2015,"Kentucky",25569,19995,607,1792,47963
"3320",2015,"Louisiana",27778,25151,1302,2256,56487
"3321",2015,"Maine",7493,5410,329,506,13738
"3322",2015,"Mariana Islands",0,1,0,0,1
"3323",2015,"Maryland",4750,10241,112,34,15137
"3324",2015,"Massachusetts",9398,4762,864,574,15598
"3325",2015,"Michigan",25578,18826,743,702,45849
"3326",2015,"Minnesota",16319,15491,1071,998,33879
"3327",2015,"Mississippi",20000,18908,540,1504,40952
"3328",2015,"Missouri",43300,30091,2272,3298,78961
"3329",2015,"Montana",5902,7250,203,472,13827
"3330",2015,"Nebraska",282,4801,36,14,5133
"3331",2015,"Nevada",9510,5088,339,924,15861
"3332",2015,"New Hampshire",9537,5204,236,10,14987
"3333",2015,"New Jersey",4304,6531,183,0,11018
"3334",2015,"New Mexico",9027,7653,553,816,18049
"3335",2015,"New York",15179,27786,1300,502,44767
"3336",2015,"North Carolina",2536,31238,1282,582,35638
"3337",2015,"North Dakota",3056,4212,105,296,7669
"3338",2015,"Ohio",60280,38256,2942,4186,105664
"3339",2015,"Oklahoma",28388,21086,1550,2738,53762
"3340",2015,"Oregon",23952,17062,0,0,41014
"3341",2015,"Pennsylvania",90055,18758,0,0,108813
"3342",2015,"Puerto Rico",1048,234,31,36,1349
"3343",2015,"Rhode Island",1663,1316,130,426,3535
"3344",2015,"South Carolina",21019,16517,1000,1298,39834
"3345",2015,"South Dakota",5240,6979,272,532,13023
"3346",2015,"Tennessee",51923,36311,0,4432,92666
"3347",2015,"Texas",107224,80247,4585,9010,201066
"3348",2015,"Utah",8559,9114,379,724,18776
"3349",2015,"Vermont",2428,2058,151,172,4809
"3350",2015,"Virgin Islands",34,2,0,0,36
"3351",2015,"Virginia",41097,29651,1547,0,72295
"3352",2015,"Washington",29473,18515,2380,1674,52042
"3353",2015,"West Virginia",15080,13869,476,1302,30727
"3354",2015,"Wisconsin",24898,17831,1134,116,43979
"3355",2015,"Wyoming",3900,3754,167,290,8111
"3356",2015,"Alabama",23022,22650,859,2356,48887
"3357",2015,"Alaska",3062,3209,191,368,6830
"3358",2015,"Arizona",12382,9041,707,1236,23366
"3359",2015,"Arkansas",6359,11611,168,752,18890
"3360",2015,"California",41181,35007,4559,0,80747
"3361",2015,"Colorado",19784,16082,932,2302,39100
"3362",2015,"Connecticut",11594,5072,134,0,16800
"3363",2015,"Delaware",2152,2424,65,144,4785
"3364",2015,"District of Columbia",54,2,0,0,56
"3365",2015,"Florida",50796,28981,2268,3914,85959
"3366",2015,"Georgia",16635,15227,448,1516,33826
"3367",2015,"Guam",100,55,12,6,173
"3368",2015,"Hawaii",0,0,0,0,0
"3369",2015,"Idaho",3609,5227,190,378,9404
"3370",2015,"Illinois",24412,17227,0,2064,43703
"3371",2015,"Indiana",25519,20227,1113,1616,48475
"3372",2015,"Iowa",267,4596,27,8,4898
"3373",2015,"Kansas",7086,8702,311,792,16891
"3374",2015,"Kentucky",12155,14847,254,1296,28552
"3375",2015,"Louisiana",14708,17368,697,1586,34359
"3376",2015,"Maine",4048,4387,135,342,8912
"3377",2015,"Mariana Islands",0,0,0,0,0
"3378",2015,"Maryland",3220,8310,96,18,11644
"3379",2015,"Massachusetts",6083,3931,402,350,10766
"3380",2015,"Michigan",13634,17604,385,476,32099
"3381",2015,"Minnesota",9373,14173,486,660,24692
"3382",2015,"Mississippi",9785,13191,267,1046,24289
"3383",2015,"Missouri",21135,22852,1004,2120,47111
"3384",2015,"Montana",2848,5170,90,394,8502
"3385",2015,"Nebraska",173,3724,23,20,3940
"3386",2015,"Nevada",4889,3272,193,574,8928
"3387",2015,"New Hampshire",4847,4165,95,4,9111
"3388",2015,"New Jersey",3462,4704,147,0,8313
"3389",2015,"New Mexico",5247,4974,334,554,11109
"3390",2015,"New York",8650,23519,665,298,33132
"3391",2015,"North Carolina",1370,20107,576,404,22457
"3392",2015,"North Dakota",1720,3744,65,158,5687
"3393",2015,"Ohio",34878,31817,1392,2966,71053
"3394",2015,"Oklahoma",15005,14753,778,1996,32532
"3395",2015,"Oregon",13586,11832,0,0,25418
"3396",2015,"Pennsylvania",62752,16297,0,0,79049
"3397",2015,"Puerto Rico",1033,170,11,40,1254
"3398",2015,"Rhode Island",954,932,57,270,2213
"3399",2015,"South Carolina",11452,10393,561,876,23282
"3400",2015,"South Dakota",2765,5484,143,302,8694
"3401",2015,"Tennessee",28815,24023,0,2600,55438
"3402",2015,"Texas",56941,51670,2532,6096,117239
"3403",2015,"Utah",4314,5857,195,524,10890
"3404",2015,"Vermont",1189,1826,49,140,3204
"3405",2015,"Virgin Islands",13,2,0,2,17
"3406",2015,"Virginia",24052,22348,974,0,47374
"3407",2015,"Washington",15822,12425,1238,1212,30697
"3408",2015,"West Virginia",6953,11561,224,956,19694
"3409",2015,"Wisconsin",13700,17759,458,90,32007
"3410",2015,"Wyoming",1745,2372,87,208,4412
"3411",2015,"Alabama",17810,14789,757,1806,35162
"3412",2015,"Alaska",4016,4414,264,642,9336
"3413",2015,"Arizona",10928,7308,741,1100,20077
"3414",2015,"Arkansas",5524,8839,164,810,15337
"3415",2015,"California",37977,26151,3912,0,68040
"3416",2015,"Colorado",17059,14870,938,2032,34899
"3417",2015,"Connecticut",9306,4207,183,0,13696
"3418",2015,"Delaware",1786,1774,93,140,3793
"3419",2015,"District of Columbia",66,0,0,0,66
"3420",2015,"Florida",45304,22587,2456,3652,73999
"3421",2015,"Georgia",13192,12217,444,1164,27017
"3422",2015,"Guam",119,64,22,16,221
"3423",2015,"Hawaii",0,0,0,0,0
"3424",2015,"Idaho",2873,5535,176,364,8948
"3425",2015,"Illinois",19306,12361,0,1370,33037
"3426",2015,"Indiana",18633,13859,1055,1254,34801
"3427",2015,"Iowa",172,3318,26,8,3524
"3428",2015,"Kansas",5542,5960,333,660,12495
"3429",2015,"Kentucky",9520,10953,260,1176,21909
"3430",2015,"Louisiana",11765,14348,689,1228,28030
"3431",2015,"Maine",4028,6036,159,418,10641
"3432",2015,"Mariana Islands",0,1,0,0,1
"3433",2015,"Maryland",3389,6110,132,32,9663
"3434",2015,"Massachusetts",5226,3146,367,328,9067
"3435",2015,"Michigan",10948,13244,341,416,24949
"3436",2015,"Minnesota",8661,18163,502,758,28084
"3437",2015,"Mississippi",7726,8231,279,854,17090
"3438",2015,"Missouri",18686,18848,1044,1962,40540
"3439",2015,"Montana",2701,6840,111,460,10112
"3440",2015,"Nebraska",168,2645,17,14,2844
"3441",2015,"Nevada",4292,2549,210,510,7561
"3442",2015,"New Hampshire",4303,3910,116,8,8337
"3443",2015,"New Jersey",3668,3507,140,0,7315
"3444",2015,"New Mexico",5346,4341,314,526,10527
"3445",2015,"New York",8329,19836,590,342,29097
"3446",2015,"North Carolina",1203,15479,602,538,17822
"3447",2015,"North Dakota",1634,4868,87,170,6759
"3448",2015,"Ohio",27354,20613,1347,2508,51822
"3449",2015,"Oklahoma",11653,10868,743,1820,25084
"3450",2015,"Oregon",13732,11626,0,0,25358
"3451",2015,"Pennsylvania",50119,10921,0,0,61040
"3452",2015,"Puerto Rico",1057,196,12,32,1297
"3453",2015,"Rhode Island",923,788,52,282,2045
"3454",2015,"South Carolina",8301,7176,406,678,16561
"3455",2015,"South Dakota",2483,6689,259,352,9783
"3456",2015,"Tennessee",24423,17480,0,2310,44213
"3457",2015,"Texas",43428,41157,2836,5292,92713
"3458",2015,"Utah",2831,3827,158,348,7164
"3459",2015,"Vermont",1183,1942,58,130,3313
"3460",2015,"Virgin Islands",19,2,0,0,21
"3461",2015,"Virginia",20672,17008,908,0,38588
"3462",2015,"Washington",14937,12315,1441,1142,29835
"3463",2015,"West Virginia",6286,8427,237,928,15878
"3464",2015,"Wisconsin",12731,16908,603,104,30346
"3465",2015,"Wyoming",1535,2274,80,204,4093
"3466",2015,"Alabama",16038,13392,710,1638,31778
"3467",2015,"Alaska",2294,3037,130,318,5779
"3468",2015,"Arizona",10378,7529,677,1040,19624
"3469",2015,"Arkansas",5356,6595,146,706,12803
"3470",2015,"California",31897,24471,3429,0,59797
"3471",2015,"Colorado",15186,12898,849,1954,30887
"3472",2015,"Connecticut",8330,3566,166,0,12062
"3473",2015,"Delaware",1503,1419,50,76,3048
"3474",2015,"District of Columbia",40,1,0,0,41
"3475",2015,"Florida",40647,20159,2615,3454,66875
"3476",2015,"Georgia",12323,9659,402,1080,23464
"3477",2015,"Guam",117,48,13,6,184
"3478",2015,"Hawaii",0,0,0,0,0
"3479",2015,"Idaho",2782,5055,104,338,8279
"3480",2015,"Illinois",17451,12693,0,1532,31676
"3481",2015,"Indiana",16754,11905,965,1236,30860
"3482",2015,"Iowa",191,2514,23,10,2738
"3483",2015,"Kansas",4889,5167,258,546,10860
"3484",2015,"Kentucky",8437,8102,214,1112,17865
"3485",2015,"Louisiana",16564,15861,771,1770,34966
"3486",2015,"Maine",3272,4190,130,530,8122
"3487",2015,"Mariana Islands",0,1,0,0,1
"3488",2015,"Maryland",2615,4779,148,18,7560
"3489",2015,"Massachusetts",4543,2442,288,278,7551
"3490",2015,"Michigan",9276,11046,315,364,21001
"3491",2015,"Minnesota",7639,14880,389,620,23528
"3492",2015,"Mississippi",9974,8720,263,1082,20039
"3493",2015,"Missouri",16053,13650,862,1800,32365
"3494",2015,"Montana",2641,5616,118,430,8805
"3495",2015,"Nebraska",138,2012,8,12,2170
"3496",2015,"Nevada",4183,2499,191,528,7401
"3497",2015,"New Hampshire",3802,3112,101,10,7025
"3498",2015,"New Jersey",3215,2728,113,0,6056
"3499",2015,"New Mexico",4763,4167,310,502,9742
"3500",2015,"New York",7532,15898,544,264,24238
"3501",2015,"North Carolina",1131,12571,581,428,14711
"3502",2015,"North Dakota",1399,3360,61,162,4982
"3503",2015,"Ohio",23309,16734,1383,2296,43722
"3504",2015,"Oklahoma",10331,9491,657,1644,22123
"3505",2015,"Oregon",10419,11137,0,0,21556
"3506",2015,"Pennsylvania",42205,8762,0,0,50967
"3507",2015,"Puerto Rico",1036,214,16,52,1318
"3508",2015,"Rhode Island",816,585,37,224,1662
"3509",2015,"South Carolina",8089,6836,410,752,16087
"3510",2015,"South Dakota",2119,4338,248,292,6997
"3511",2015,"Tennessee",21223,14758,0,2094,38075
"3512",2015,"Texas",39567,45376,2578,4864,92385
"3513",2015,"Utah",2735,4094,131,326,7286
"3514",2015,"Vermont",1091,1464,64,118,2737
"3515",2015,"Virgin Islands",25,1,0,2,28
"3516",2015,"Virginia",18720,13891,862,0,33473
"3517",2015,"Washington",13341,10892,1201,1158,26592
"3518",2015,"West Virginia",5537,6493,195,770,12995
"3519",2015,"Wisconsin",11463,13481,514,74,25532
"3520",2015,"Wyoming",1498,2275,100,194,4067
"3521",2015,"Alabama",17991,13613,703,1792,34099
"3522",2015,"Alaska",2570,3440,142,322,6474
"3523",2015,"Arizona",9987,7109,651,1072,18819
"3524",2015,"Arkansas",5352,5941,155,566,12014
"3525",2015,"California",33938,26257,3935,0,64130
"3526",2015,"Colorado",15890,12572,776,1816,31054
"3527",2015,"Connecticut",8418,3398,175,0,11991
"3528",2015,"Delaware",1570,1392,57,124,3143
"3529",2015,"District of Columbia",65,2,0,0,67
"3530",2015,"Florida",42171,20307,2373,3400,68251
"3531",2015,"Georgia",12736,9241,393,1022,23392
"3532",2015,"Guam",84,42,15,10,151
"3533",2015,"Hawaii",0,0,0,0,0
"3534",2015,"Idaho",2723,4163,118,346,7350
"3535",2015,"Illinois",18088,11085,0,1286,30459
"3536",2015,"Indiana",16546,11880,894,1020,30340
"3537",2015,"Iowa",170,2288,14,6,2478
"3538",2015,"Kansas",5378,5354,244,558,11534
"3539",2015,"Kentucky",8238,7362,201,906,16707
"3540",2015,"Louisiana",13992,11514,650,1440,27596
"3541",2015,"Maine",2966,3249,149,314,6678
"3542",2015,"Mariana Islands",0,1,0,0,1
"3543",2015,"Maryland",2783,4315,101,20,7219
"3544",2015,"Massachusetts",5177,2623,329,376,8505
"3545",2015,"Michigan",9157,9431,279,282,19149
"3546",2015,"Minnesota",7643,11193,370,588,19794
"3547",2015,"Mississippi",7830,6651,210,604,15295
"3548",2015,"Missouri",16501,13231,941,1692,32365
"3549",2015,"Montana",2688,4672,116,432,7908
"3550",2015,"Nebraska",140,1955,16,8,2119
"3551",2015,"Nevada",3949,2462,178,468,7057
"3552",2015,"New Hampshire",3870,3100,77,0,7047
"3553",2015,"New Jersey",3555,2840,142,0,6537
"3554",2015,"New Mexico",5029,3835,272,524,9660
"3555",2015,"New York",7501,12410,492,244,20647
"3556",2015,"North Carolina",1063,11789,575,392,13819
"3557",2015,"North Dakota",1409,2855,70,120,4454
"3558",2015,"Ohio",23147,15795,1132,2062,42136
"3559",2015,"Oklahoma",11425,9936,737,1598,23696
"3560",2015,"Oregon",10589,8789,0,0,19378
"3561",2015,"Pennsylvania",41542,7972,0,0,49514
"3562",2015,"Puerto Rico",1070,227,24,46,1367
"3563",2015,"Rhode Island",740,575,41,228,1584
"3564",2015,"South Carolina",8487,6785,479,578,16329
"3565",2015,"South Dakota",2233,3728,204,300,6465
"3566",2015,"Tennessee",22983,15384,0,1910,40277
"3567",2015,"Texas",41503,40561,2433,4502,88999
"3568",2015,"Utah",2689,3477,114,324,6604
"3569",2015,"Vermont",1171,1190,46,112,2519
"3570",2015,"Virgin Islands",18,2,0,0,20
"3571",2015,"Virginia",18252,12733,793,0,31778
"3572",2015,"Washington",12705,9373,1070,1026,24174
"3573",2015,"West Virginia",5565,5742,181,862,12350
"3574",2015,"Wisconsin",11549,11531,421,74,23575
"3575",2015,"Wyoming",1578,2045,80,200,3903
"3576",2015,"Alabama",17698,10276,653,1592,30219
"3577",2015,"Alaska",2709,2439,116,328,5592
"3578",2015,"Arizona",10226,6078,668,972,17944
"3579",2015,"Arkansas",5216,4146,165,502,10029
"3580",2015,"California",39980,27844,3995,0,71819
"3581",2015,"Colorado",15828,10903,751,1736,29218
"3582",2015,"Connecticut",8660,3012,158,0,11830
"3583",2015,"Delaware",1523,1148,58,72,2801
"3584",2015,"District of Columbia",59,5,0,0,64
"3585",2015,"Florida",42570,18069,2133,3196,65968
"3586",2015,"Georgia",12674,6707,347,1032,20760
"3587",2015,"Guam",119,51,13,6,189
"3588",2015,"Hawaii",0,0,0,0,0
"3589",2015,"Idaho",2576,3125,121,312,6134
"3590",2015,"Illinois",18469,9243,0,1404,29116
"3591",2015,"Indiana",15416,8954,758,858,25986
"3592",2015,"Iowa",120,1563,22,6,1711
"3593",2015,"Kansas",5641,3849,227,572,10289
"3594",2015,"Kentucky",8223,5645,238,934,15040
"3595",2015,"Louisiana",11858,7371,606,1042,20877
"3596",2015,"Maine",2973,2469,117,238,5797
"3597",2015,"Mariana Islands",0,0,1,0,1
"3598",2015,"Maryland",2918,3750,100,16,6784
"3599",2015,"Massachusetts",4617,1993,326,280,7216
"3600",2015,"Michigan",8837,6681,296,306,16120
"3601",2015,"Minnesota",6949,7139,362,598,15048
"3602",2015,"Mississippi",7869,4333,240,556,12998
"3603",2015,"Missouri",16736,10260,935,1620,29551
"3604",2015,"Montana",2563,3612,92,372,6639
"3605",2015,"Nebraska",103,1332,12,10,1457
"3606",2015,"Nevada",4074,2201,186,420,6881
"3607",2015,"New Hampshire",3675,2517,93,0,6285
"3608",2015,"New Jersey",3925,2538,125,0,6588
"3609",2015,"New Mexico",4745,3325,251,526,8847
"3610",2015,"New York",8140,9957,416,228,18741
"3611",2015,"North Carolina",964,9325,531,412,11232
"3612",2015,"North Dakota",1400,2040,57,204,3701
"3613",2015,"Ohio",23344,13252,1224,1796,39616
"3614",2015,"Oklahoma",11162,7162,690,1620,20634
"3615",2015,"Oregon",9956,8029,0,0,17985
"3616",2015,"Pennsylvania",38287,6885,0,0,45172
"3617",2015,"Puerto Rico",1083,213,12,56,1364
"3618",2015,"Rhode Island",739,520,78,236,1573
"3619",2015,"South Carolina",8486,4989,379,548,14402
"3620",2015,"South Dakota",1926,2605,132,218,4881
"3621",2015,"Tennessee",22803,12231,0,1906,36940
"3622",2015,"Texas",41237,27981,2300,4404,75922
"3623",2015,"Utah",2586,2842,179,278,5885
"3624",2015,"Vermont",1178,939,57,86,2260
"3625",2015,"Virgin Islands",28,3,0,4,35
"3626",2015,"Virginia",19564,11481,738,0,31783
"3627",2015,"Washington",12222,8220,1000,958,22400
"3628",2015,"West Virginia",5632,4503,186,756,11077
"3629",2015,"Wisconsin",11408,7673,428,66,19575
"3630",2015,"Wyoming",1512,1778,65,170,3525
"3631",2015,"Alabama",15299,8861,541,1196,25897
"3632",2015,"Alaska",2612,2256,113,282,5263
"3633",2015,"Arizona",9616,5804,587,910,16917
"3634",2015,"Arkansas",4881,3689,162,490,9222
"3635",2015,"California",33287,22795,3763,0,59845
"3636",2015,"Colorado",15127,10700,722,1652,28201
"3637",2015,"Connecticut",9429,3201,119,0,12749
"3638",2015,"Delaware",1589,1169,59,84,2901
"3639",2015,"District of Columbia",45,4,0,0,49
"3640",2015,"Florida",39592,17115,1989,2790,61486
"3641",2015,"Georgia",11502,6000,279,788,18569
"3642",2015,"Guam",108,56,15,10,189
"3643",2015,"Hawaii",0,0,0,0,0
"3644",2015,"Idaho",2381,3063,126,304,5874
"3645",2015,"Illinois",17666,8230,0,1166,27062
"3646",2015,"Indiana",14845,8455,742,1026,25068
"3647",2015,"Iowa",184,1634,24,6,1848
"3648",2015,"Kansas",4610,3174,222,414,8420
"3649",2015,"Kentucky",7280,5300,178,804,13562
"3650",2015,"Louisiana",10584,6441,529,896,18450
"3651",2015,"Maine",2906,2155,127,214,5402
"3652",2015,"Mariana Islands",0,2,0,0,2
"3653",2015,"Maryland",2929,3776,91,24,6820
"3654",2015,"Massachusetts",4398,2122,284,228,7032
"3655",2015,"Michigan",8683,6668,313,306,15970
"3656",2015,"Minnesota",7117,7084,358,476,15035
"3657",2015,"Mississippi",6160,3422,207,460,10249
"3658",2015,"Missouri",16285,9733,949,1510,28477
"3659",2015,"Montana",2514,3684,83,344,6625
"3660",2015,"Nebraska",142,1238,14,2,1396
"3661",2015,"Nevada",3778,2373,164,380,6695
"3662",2015,"New Hampshire",3745,2356,63,2,6166
"3663",2015,"New Jersey",4261,2606,140,0,7007
"3664",2015,"New Mexico",4546,3374,307,418,8645
"3665",2015,"New York",8140,10400,444,300,19284
"3666",2015,"North Carolina",1034,8587,459,380,10460
"3667",2015,"North Dakota",1335,2008,57,110,3510
"3668",2015,"Ohio",22545,13307,1118,1778,38748
"3669",2015,"Oklahoma",10529,6612,679,1328,19148
"3670",2015,"Oregon",9661,8073,0,0,17734
"3671",2015,"Pennsylvania",39007,6733,0,0,45740
"3672",2015,"Puerto Rico",1228,198,26,72,1524
"3673",2015,"Rhode Island",797,572,31,210,1610
"3674",2015,"South Carolina",7693,4135,351,592,12771
"3675",2015,"South Dakota",1866,2611,126,248,4851
"3676",2015,"Tennessee",18596,10241,0,1666,30503
"3677",2015,"Texas",43199,27650,2432,4228,77509
"3678",2015,"Utah",2549,2745,152,272,5718
"3679",2015,"Vermont",1149,890,52,78,2169
"3680",2015,"Virgin Islands",25,4,0,0,29
"3681",2015,"Virginia",16539,10126,733,0,27398
"3682",2015,"Washington",12207,8243,905,1024,22379
"3683",2015,"West Virginia",5468,4455,193,590,10706
"3684",2015,"Wisconsin",9973,7540,466,68,18047
"3685",2015,"Wyoming",1380,1731,62,140,3313
"3686",2015,"Alabama",15629,9031,525,1262,26447
"3687",2015,"Alaska",2866,2337,178,332,5713
"3688",2015,"Arizona",10829,6105,590,836,18360
"3689",2015,"Arkansas",4871,3881,170,536,9458
"3690",2015,"California",36049,25174,3848,0,65071
"3691",2015,"Colorado",15660,11252,776,1758,29446
"3692",2015,"Connecticut",9170,3432,152,0,12754
"3693",2015,"Delaware",1597,1197,38,110,2942
"3694",2015,"District of Columbia",50,3,0,0,53
"3695",2015,"Florida",39775,17145,1962,2840,61722
"3696",2015,"Georgia",11029,5941,323,810,18103
"3697",2015,"Guam",91,44,7,12,154
"3698",2015,"Hawaii",0,0,0,0,0
"3699",2015,"Idaho",2751,3569,131,314,6765
"3700",2015,"Illinois",19457,9346,0,1286,30089
"3701",2015,"Indiana",15952,8778,744,1132,26606
"3702",2015,"Iowa",167,1781,12,18,1978
"3703",2015,"Kansas",5200,3969,233,524,9926
"3704",2015,"Kentucky",7321,5133,185,786,13425
"3705",2015,"Louisiana",9916,6452,542,882,17792
"3706",2015,"Maine",2593,2273,110,216,5192
"3707",2015,"Mariana Islands",0,1,0,0,1
"3708",2015,"Maryland",2665,3972,88,28,6753
"3709",2015,"Massachusetts",4529,2296,267,222,7314
"3710",2015,"Michigan",9289,6839,260,326,16714
"3711",2015,"Minnesota",8050,7795,382,568,16795
"3712",2015,"Mississippi",6734,3669,159,476,11038
"3713",2015,"Missouri",17111,10085,799,1460,29455
"3714",2015,"Montana",2840,4108,75,446,7469
"3715",2015,"Nebraska",104,1455,13,22,1594
"3716",2015,"Nevada",4200,2611,170,424,7405
"3717",2015,"New Hampshire",3813,2468,55,2,6338
"3718",2015,"New Jersey",4118,2453,133,0,6704
"3719",2015,"New Mexico",5143,3645,268,508,9564
"3720",2015,"New York",7767,10516,449,228,18960
"3721",2015,"North Carolina",1155,8393,482,364,10394
"3722",2015,"North Dakota",1507,2349,49,136,4041
"3723",2015,"Ohio",22978,12473,1026,1916,38393
"3724",2015,"Oklahoma",11082,7434,845,1348,20709
"3725",2015,"Oregon",10537,8722,0,0,19259
"3726",2015,"Pennsylvania",38419,6825,0,0,45244
"3727",2015,"Puerto Rico",1263,149,36,34,1482
"3728",2015,"Rhode Island",865,520,35,244,1664
"3729",2015,"South Carolina",7725,4088,395,546,12754
"3730",2015,"South Dakota",2260,2932,139,258,5589
"3731",2015,"Tennessee",18928,10314,0,1546,30788
"3732",2015,"Texas",44935,29899,2679,4466,81979
"3733",2015,"Utah",2927,2935,141,322,6325
"3734",2015,"Vermont",1152,921,47,96,2216
"3735",2015,"Virgin Islands",12,2,0,4,18
"3736",2015,"Virginia",17065,9854,680,0,27599
"3737",2015,"Washington",12928,8555,1034,922,23439
"3738",2015,"West Virginia",5596,4499,185,766,11046
"3739",2015,"Wisconsin",10130,8532,483,56,19201
"3740",2015,"Wyoming",1758,1871,93,194,3916
"3741",2015,"Alabama",14929,9809,602,1256,26596
"3742",2015,"Alaska",3107,2908,186,400,6601
"3743",2015,"Arizona",11236,6438,694,900,19268
"3744",2015,"Arkansas",4951,4514,168,588,10221
"3745",2015,"California",35479,25542,4370,0,65391
"3746",2015,"Colorado",15865,11795,935,1922,30517
"3747",2015,"Connecticut",9624,3635,122,0,13381
"3748",2015,"Delaware",1720,1228,64,114,3126
"3749",2015,"District of Columbia",49,2,0,0,51
"3750",2015,"Florida",40786,18180,1996,2702,63664
"3751",2015,"Georgia",11926,6472,336,852,19586
"3752",2015,"Guam",84,42,15,10,151
"3753",2015,"Hawaii",0,0,0,0,0
"3754",2015,"Idaho",2712,3727,140,322,6901
"3755",2015,"Illinois",19123,9918,0,1318,30359
"3756",2015,"Indiana",16372,10732,823,1082,29009
"3757",2015,"Iowa",211,2163,13,8,2395
"3758",2015,"Kansas",5754,4392,242,528,10916
"3759",2015,"Kentucky",8012,6829,245,964,16050
"3760",2015,"Louisiana",9998,6632,588,894,18112
"3761",2015,"Maine",3112,2984,142,316,6554
"3762",2015,"Mariana Islands",0,2,0,0,2
"3763",2015,"Maryland",3227,5116,100,32,8475
"3764",2015,"Massachusetts",5205,2642,354,270,8471
"3765",2015,"Michigan",10428,8134,389,340,19291
"3766",2015,"Minnesota",9626,10862,503,730,21721
"3767",2015,"Mississippi",6771,4061,181,518,11531
"3768",2015,"Missouri",17715,12531,812,1852,32910
"3769",2015,"Montana",2695,4166,97,378,7336
"3770",2015,"Nebraska",134,1586,12,4,1736
"3771",2015,"Nevada",3891,2533,189,440,7053
"3772",2015,"New Hampshire",4277,3015,97,2,7391
"3773",2015,"New Jersey",4462,3002,130,0,7594
"3774",2015,"New Mexico",5084,3754,287,438,9563
"3775",2015,"New York",9004,13499,557,298,23358
"3776",2015,"North Carolina",950,9667,535,404,11556
"3777",2015,"North Dakota",1530,2666,77,160,4433
"3778",2015,"Ohio",26841,16124,1256,2044,46265
"3779",2015,"Oklahoma",12508,8819,841,1552,23720
"3780",2015,"Oregon",11238,9305,0,0,20543
"3781",2015,"Pennsylvania",45156,7908,0,0,53064
"3782",2015,"Puerto Rico",954,170,25,26,1175
"3783",2015,"Rhode Island",931,594,66,226,1817
"3784",2015,"South Carolina",8123,4493,364,572,13552
"3785",2015,"South Dakota",2474,3118,162,314,6068
"3786",2015,"Tennessee",19190,11361,0,1672,32223
"3787",2015,"Texas",41412,29218,2447,4104,77181
"3788",2015,"Utah",2720,3124,134,306,6284
"3789",2015,"Vermont",1470,1477,57,148,3152
"3790",2015,"Virgin Islands",18,6,0,2,26
"3791",2015,"Virginia",18272,12038,686,0,30996
"3792",2015,"Washington",14397,9063,1206,1012,25678
"3793",2015,"West Virginia",6777,5845,206,742,13570
"3794",2015,"Wisconsin",11606,12006,564,86,24262
"3795",2015,"Wyoming",1668,1995,70,194,3927
"3796",2015,"Alabama",17870,12707,701,1464,32742
"3797",2015,"Alaska",3114,3092,206,342,6754
"3798",2015,"Arizona",12720,7999,777,1158,22654
"3799",2015,"Arkansas",7010,5843,198,624,13675
"3800",2015,"California",38597,30120,3822,0,72539
"3801",2015,"Colorado",17716,14259,939,2224,35138
"3802",2015,"Connecticut",11432,4709,250,0,16391
"3803",2015,"Delaware",2145,1741,77,150,4113
"3804",2015,"District of Columbia",62,4,0,4,70
"3805",2015,"Florida",46739,22690,2279,3328,75036
"3806",2015,"Georgia",16366,9436,459,1166,27427
"3807",2015,"Guam",96,47,13,10,166
"3808",2015,"Hawaii",0,0,0,0,0
"3809",2015,"Idaho",3303,4416,179,330,8228
"3810",2015,"Illinois",17517,10329,0,1362,29208
"3811",2015,"Indiana",22176,13898,1201,1340,38615
"3812",2015,"Iowa",295,3211,24,14,3544
"3813",2015,"Kansas",6823,5529,296,634,13282
"3814",2015,"Kentucky",10407,8327,283,1058,20075
"3815",2015,"Louisiana",12506,9438,797,1178,23919
"3816",2015,"Maine",3634,3215,207,312,7368
"3817",2015,"Mariana Islands",0,2,0,0,2
"3818",2015,"Maryland",3235,5268,134,36,8673
"3819",2015,"Massachusetts",6905,3446,380,344,11075
"3820",2015,"Michigan",13506,10617,431,456,25010
"3821",2015,"Minnesota",10796,12244,575,818,24433
"3822",2015,"Mississippi",8788,5791,276,624,15479
"3823",2015,"Missouri",23164,15636,1086,2074,41960
"3824",2015,"Montana",3203,4804,125,468,8600
"3825",2015,"Nebraska",123,2037,16,14,2190
"3826",2015,"Nevada",4938,3075,242,542,8797
"3827",2015,"New Hampshire",4853,3215,105,0,8173
"3828",2015,"New Jersey",4924,3456,149,0,8529
"3829",2015,"New Mexico",6149,4853,357,550,11909
"3830",2015,"New York",9776,14574,663,308,25321
"3831",2015,"North Carolina",1182,12154,639,416,14391
"3832",2015,"North Dakota",2086,3302,92,210,5690
"3833",2015,"Ohio",32293,20400,1797,2700,57190
"3834",2015,"Oklahoma",14307,10437,981,1784,27509
"3835",2015,"Oregon",12693,11105,0,0,23798
"3836",2015,"Pennsylvania",56770,10644,0,0,67414
"3837",2015,"Puerto Rico",1131,163,59,34,1387
"3838",2015,"Rhode Island",1038,743,54,224,2059
"3839",2015,"South Carolina",9999,6364,446,648,17457
"3840",2015,"South Dakota",3103,4041,169,386,7699
"3841",2015,"Tennessee",22617,14513,0,1934,39064
"3842",2015,"Texas",53371,36853,2987,5068,98279
"3843",2015,"Utah",3186,3867,159,322,7534
"3844",2015,"Vermont",1522,1485,51,108,3166
"3845",2015,"Virgin Islands",9,3,0,0,12
"3846",2015,"Virginia",22865,15230,923,0,39018
"3847",2015,"Washington",15965,11213,1310,1072,29560
"3848",2015,"West Virginia",9314,6894,307,1006,17521
"3849",2015,"Wisconsin",14792,14421,680,66,29959
"3850",2015,"Wyoming",2023,2247,96,254,4620
"3851",2015,"Alabama",23552,14293,844,2218,40907
"3852",2015,"Alaska",3032,2552,211,504,6299
"3853",2015,"Arizona",13951,8211,754,1354,24270
"3854",2015,"Arkansas",8799,7037,201,1242,17279
"3855",2015,"California",37478,27480,4417,0,69375
"3856",2015,"Colorado",18284,12985,936,2340,34545
"3857",2015,"Connecticut",9806,3890,246,0,13942
"3858",2015,"Delaware",2135,1681,79,150,4045
"3859",2015,"District of Columbia",53,0,0,0,53
"3860",2015,"Florida",52791,24827,2303,3948,83869
"3861",2015,"Georgia",22438,11166,493,1924,36021
"3862",2015,"Guam",86,47,11,6,150
"3863",2015,"Hawaii",0,0,0,0,0
"3864",2015,"Idaho",3723,4415,206,548,8892
"3865",2015,"Illinois",23614,13379,0,2028,39021
"3866",2015,"Indiana",24373,13650,1152,1306,40481
"3867",2015,"Iowa",268,2984,35,14,3301
"3868",2015,"Kansas",7694,6109,320,954,15077
"3869",2015,"Kentucky",13909,9486,310,2084,25789
"3870",2015,"Louisiana",13427,9717,631,1286,25061
"3871",2015,"Maine",2962,2545,169,290,5966
"3872",2015,"Mariana Islands",0,3,2,0,5
"3873",2015,"Maryland",2815,4670,144,46,7675
"3874",2015,"Massachusetts",4621,2174,295,258,7348
"3875",2015,"Michigan",13093,9906,414,400,23813
"3876",2015,"Minnesota",9846,9858,645,748,21097
"3877",2015,"Mississippi",11559,6964,258,1048,19829
"3878",2015,"Missouri",26048,15858,1120,2692,45718
"3879",2015,"Montana",3178,4248,131,628,8185
"3880",2015,"Nebraska",133,2156,25,4,2318
"3881",2015,"Nevada",5338,3100,229,542,9209
"3882",2015,"New Hampshire",4184,2529,109,6,6828
"3883",2015,"New Jersey",4101,3005,123,0,7229
"3884",2015,"New Mexico",6039,4625,342,894,11900
"3885",2015,"New York",8512,13343,643,306,22804
"3886",2015,"North Carolina",1364,14638,772,792,17566
"3887",2015,"North Dakota",1862,2783,106,188,4939
"3888",2015,"Ohio",34137,18836,1682,3190,57845
"3889",2015,"Oklahoma",16251,10864,932,2482,30529
"3890",2015,"Oregon",13230,10932,0,0,24162
"3891",2015,"Pennsylvania",51886,8727,0,0,60613
"3892",2015,"Puerto Rico",1054,187,11,46,1298
"3893",2015,"Rhode Island",922,635,59,272,1888
"3894",2015,"South Carolina",13831,7072,500,1004,22407
"3895",2015,"South Dakota",3449,4167,173,422,8211
"3896",2015,"Tennessee",27069,16763,0,2452,46284
"3897",2015,"Texas",60204,39798,3091,6978,110071
"3898",2015,"Utah",3668,4018,211,434,8331
"3899",2015,"Vermont",1649,1421,83,130,3283
"3900",2015,"Virgin Islands",8,2,0,0,10
"3901",2015,"Virginia",23999,15237,1040,0,40276
"3902",2015,"Washington",15771,11434,1431,1482,30118
"3903",2015,"West Virginia",9538,7719,262,1442,18961
"3904",2015,"Wisconsin",13332,12361,746,122,26561
"3905",2015,"Wyoming",2131,2092,117,310,4650
"3906",2015,"Alabama",16291,12944,849,1478,31562
"3907",2015,"Alaska",2439,2050,225,214,4928
"3908",2015,"Arizona",10585,6808,723,1020,19136
"3909",2015,"Arkansas",5295,5760,202,638,11895
"3910",2015,"California",37560,23524,4060,0,65144
"3911",2015,"Colorado",15739,11932,1031,1794,30496
"3912",2015,"Connecticut",9910,3891,211,0,14012
"3913",2015,"Delaware",1910,1596,82,168,3756
"3914",2015,"District of Columbia",55,6,0,0,61
"3915",2015,"Florida",43909,21939,2433,3504,71785
"3916",2015,"Georgia",13650,9280,404,1156,24490
"3917",2015,"Guam",101,49,13,2,165
"3918",2015,"Hawaii",0,0,0,0,0
"3919",2015,"Idaho",2568,3342,187,306,6403
"3920",2015,"Illinois",20682,12203,0,1636,34521
"3921",2015,"Indiana",18433,11935,1081,1194,32643
"3922",2015,"Iowa",197,2486,44,18,2745
"3923",2015,"Kansas",5724,5577,331,608,12240
"3924",2015,"Kentucky",9629,7663,241,1070,18603
"3925",2015,"Louisiana",10760,10358,789,996,22903
"3926",2015,"Maine",2617,2285,168,234,5304
"3927",2015,"Mariana Islands",0,0,1,0,1
"3928",2015,"Maryland",2542,4795,108,24,7469
"3929",2015,"Massachusetts",5139,2568,337,246,8290
"3930",2015,"Michigan",9260,7923,436,382,18001
"3931",2015,"Minnesota",8181,7949,604,648,17382
"3932",2015,"Mississippi",6798,6220,261,628,13907
"3933",2015,"Missouri",21243,13943,1185,1800,38171
"3934",2015,"Montana",2204,3380,114,360,6058
"3935",2015,"Nebraska",169,2057,21,12,2259
"3936",2015,"Nevada",3936,2553,219,482,7190
"3937",2015,"New Hampshire",4097,2652,118,0,6867
"3938",2015,"New Jersey",3854,3163,127,0,7144
"3939",2015,"New Mexico",4548,3689,353,776,9366
"3940",2015,"New York",9002,12478,597,282,22359
"3941",2015,"North Carolina",1291,13043,641,426,15401
"3942",2015,"North Dakota",1672,2793,81,166,4712
"3943",2015,"Ohio",26268,16186,1678,2328,46460
"3944",2015,"Oklahoma",13234,9811,1006,1664,25715
"3945",2015,"Oregon",10601,8766,0,0,19367
"3946",2015,"Pennsylvania",44966,7800,0,0,52766
"3947",2015,"Puerto Rico",1031,148,11,36,1226
"3948",2015,"Rhode Island",886,622,63,280,1851
"3949",2015,"South Carolina",8767,6156,507,578,16008
"3950",2015,"South Dakota",2399,3631,188,294,6512
"3951",2015,"Tennessee",22197,15007,0,1940,39144
"3952",2015,"Texas",44153,36397,2852,4612,88014
"3953",2015,"Utah",2923,3317,198,270,6708
"3954",2015,"Vermont",1171,1081,72,92,2416
"3955",2015,"Virgin Islands",7,4,1,0,12
"3956",2015,"Virginia",21023,14433,844,0,36300
"3957",2015,"Washington",13781,9419,1423,946,25569
"3958",2015,"West Virginia",6881,5876,289,812,13858
"3959",2015,"Wisconsin",9703,9221,608,98,19630
"3960",2015,"Wyoming",1646,1830,106,200,3782
"3961",2014,"Alabama",23630,29449,773,2260,56112
"3962",2014,"Alaska",4259,4189,305,404,9157
"3963",2014,"Arizona",14200,11509,842,1176,27727
"3964",2014,"Arkansas",8260,14121,191,796,23368
"3965",2014,"California",66770,47409,6956,0,121135
"3966",2014,"Colorado",20924,19494,1067,2370,43855
"3967",2014,"Connecticut",11516,5542,257,0,17315
"3968",2014,"Delaware",2320,3079,89,182,5670
"3969",2014,"District of Columbia",50,3,0,0,53
"3970",2014,"Florida",50412,37098,2500,3908,93918
"3971",2014,"Georgia",19541,22872,539,1572,44524
"3972",2014,"Guam",117,58,21,14,210
"3973",2014,"Hawaii",0,0,0,0,0
"3974",2014,"Idaho",4260,6913,227,410,11810
"3975",2014,"Illinois",24857,19709,0,2026,46592
"3976",2014,"Indiana",23399,21186,1044,1670,47299
"3977",2014,"Iowa",260,5574,39,12,5885
"3978",2014,"Kansas",7333,10739,363,876,19311
"3979",2014,"Kentucky",14308,17629,308,1440,33685
"3980",2014,"Louisiana",15337,25507,740,1616,43200
"3981",2014,"Maine",3653,4701,223,324,8901
"3982",2014,"Mariana Islands",0,0,0,0,0
"3983",2014,"Maryland",2839,8357,115,24,11335
"3984",2014,"Massachusetts",5486,3263,383,366,9498
"3985",2014,"Michigan",11860,15576,433,444,28313
"3986",2014,"Minnesota",9357,13082,577,738,23754
"3987",2014,"Mississippi",10726,17253,268,910,29157
"3988",2014,"Missouri",27713,25507,1224,2310,56754
"3989",2014,"Montana",3913,6802,109,546,11370
"3990",2014,"Nebraska",184,4455,29,22,4690
"3991",2014,"Nevada",5202,4356,285,596,10439
"3992",2014,"New Hampshire",5059,4122,100,4,9285
"3993",2014,"New Jersey",3796,4768,148,0,8712
"3994",2014,"New Mexico",6575,6721,383,662,14341
"3995",2014,"New York",9349,21403,604,328,31684
"3996",2014,"North Carolina",1745,27082,658,460,29945
"3997",2014,"North Dakota",2020,4018,74,202,6314
"3998",2014,"Ohio",35658,30752,1609,2872,70891
"3999",2014,"Oklahoma",19055,20488,1054,2366,42963
"4000",2014,"Oregon",14346,13994,0,0,28340
"4001",2014,"Pennsylvania",61828,12737,0,0,74565
"4002",2014,"Puerto Rico",1158,205,12,60,1435
"4003",2014,"Rhode Island",895,894,59,266,2114
"4004",2014,"South Carolina",11905,14320,477,816,27518
"4005",2014,"South Dakota",3098,5897,160,310,9465
"4006",2014,"Tennessee",30117,30298,0,2808,63223
"4007",2014,"Texas",66280,78321,3420,6604,154625
"4008",2014,"Utah",4744,8018,206,476,13444
"4009",2014,"Vermont",1306,1715,70,114,3205
"4010",2014,"Virgin Islands",13,0,0,0,13
"4011",2014,"Virginia",24410,24225,1092,0,49727
"4012",2014,"Washington",19476,15253,1647,1314,37690
"4013",2014,"West Virginia",9844,12767,338,1066,24015
"4014",2014,"Wisconsin",12139,14806,574,86,27605
"4015",2014,"Wyoming",2729,3383,111,236,6459
"4016",2014,"Alabama",16301,22502,544,1926,41273
"4017",2014,"Alaska",3047,3798,257,428,7530
"4018",2014,"Arizona",9974,9362,643,954,20933
"4019",2014,"Arkansas",5277,12356,166,674,18473
"4020",2014,"California",43779,34964,4087,0,82830
"4021",2014,"Colorado",15478,16152,847,2470,34947
"4022",2014,"Connecticut",9106,4957,167,0,14230
"4023",2014,"Delaware",1846,2649,78,110,4683
"4024",2014,"District of Columbia",43,2,0,0,45
"4025",2014,"Florida",39126,30723,1974,3610,75433
"4026",2014,"Georgia",12951,16489,418,1412,31270
"4027",2014,"Guam",89,47,17,14,167
"4028",2014,"Hawaii",0,0,0,0,0
"4029",2014,"Idaho",2611,5013,168,326,8118
"4030",2014,"Illinois",19282,18280,0,1760,39322
"4031",2014,"Indiana",16681,20381,824,1380,39266
"4032",2014,"Iowa",174,5018,19,8,5219
"4033",2014,"Kansas",5428,9622,227,742,16019
"4034",2014,"Kentucky",8807,15632,228,1108,25775
"4035",2014,"Louisiana",10660,19375,548,1284,31867
"4036",2014,"Maine",2356,4426,137,284,7203
"4037",2014,"Mariana Islands",0,1,0,2,3
"4038",2014,"Maryland",2290,8896,84,26,11296
"4039",2014,"Massachusetts",4698,3370,360,330,8758
"4040",2014,"Michigan",8752,17256,281,378,26667
"4041",2014,"Minnesota",6462,13470,405,622,20959
"4042",2014,"Mississippi",6019,13482,207,698,20406
"4043",2014,"Missouri",23419,26565,841,2240,53065
"4044",2014,"Montana",2442,5296,92,418,8248
"4045",2014,"Nebraska",135,3757,20,10,3922
"4046",2014,"Nevada",3807,3308,230,472,7817
"4047",2014,"New Hampshire",3838,3784,72,2,7696
"4048",2014,"New Jersey",3141,4357,114,0,7612
"4049",2014,"New Mexico",4734,5370,261,520,10885
"4050",2014,"New York",6959,22126,489,290,29864
"4051",2014,"North Carolina",1210,22312,483,452,24457
"4052",2014,"North Dakota",1447,4023,69,220,5759
"4053",2014,"Ohio",26893,32001,1413,2588,62895
"4054",2014,"Oklahoma",14060,17558,911,2022,34551
"4055",2014,"Oregon",10465,11486,0,0,21951
"4056",2014,"Pennsylvania",57010,13907,22,0,70939
"4057",2014,"Puerto Rico",1146,171,14,42,1373
"4058",2014,"Rhode Island",836,796,48,264,1944
"4059",2014,"South Carolina",8668,10869,412,830,20779
"4060",2014,"South Dakota",2231,5750,115,300,8396
"4061",2014,"Tennessee",21010,24913,0,2106,48029
"4062",2014,"Texas",47340,58551,2544,5630,114065
"4063",2014,"Utah",3189,5890,146,426,9651
"4064",2014,"Vermont",932,1814,47,72,2865
"4065",2014,"Virgin Islands",12,2,0,0,14
"4066",2014,"Virginia",19685,23164,898,0,43747
"4067",2014,"Washington",16080,13996,1886,1252,33214
"4068",2014,"West Virginia",6057,12780,181,912,19930
"4069",2014,"Wisconsin",8645,16950,434,102,26131
"4070",2014,"Wyoming",1675,2637,85,198,4595
"4071",2014,"Alabama",13930,14643,507,1622,30702
"4072",2014,"Alaska",3997,4406,246,580,9229
"4073",2014,"Arizona",9557,7966,577,1034,19134
"4074",2014,"Arkansas",5164,9255,138,712,15269
"4075",2014,"California",42829,30607,3536,0,76972
"4076",2014,"Colorado",14704,14649,746,2130,32229
"4077",2014,"Connecticut",8934,4654,119,0,13707
"4078",2014,"Delaware",1562,1941,65,148,3716
"4079",2014,"District of Columbia",50,1,0,2,53
"4080",2014,"Florida",38428,23668,1904,3484,67484
"4081",2014,"Georgia",11239,12696,337,1218,25490
"4082",2014,"Guam",112,40,14,12,178
"4083",2014,"Hawaii",0,0,0,0,0
"4084",2014,"Idaho",2351,5239,125,350,8065
"4085",2014,"Illinois",17927,14023,0,1556,33506
"4086",2014,"Indiana",16054,15005,733,1230,33022
"4087",2014,"Iowa",176,3667,22,6,3871
"4088",2014,"Kansas",4725,6092,248,598,11663
"4089",2014,"Kentucky",8530,11463,211,1308,21512
"4090",2014,"Louisiana",9658,15343,519,1340,26860
"4091",2014,"Maine",2800,6552,117,360,9829
"4092",2014,"Mariana Islands",0,2,0,0,2
"4093",2014,"Maryland",2410,5964,104,30,8508
"4094",2014,"Massachusetts",4902,3343,272,348,8865
"4095",2014,"Michigan",8642,13602,279,398,22921
"4096",2014,"Minnesota",7461,17386,407,748,26002
"4097",2014,"Mississippi",6024,8325,176,710,15235
"4098",2014,"Missouri",18128,20255,834,2074,41291
"4099",2014,"Montana",2651,6683,88,478,9900
"4100",2014,"Nebraska",130,2698,13,6,2847
"4101",2014,"Nevada",3830,2880,195,482,7387
"4102",2014,"New Hampshire",3975,4109,90,4,8178
"4103",2014,"New Jersey",3583,3736,116,0,7435
"4104",2014,"New Mexico",4910,4780,246,818,10754
"4105",2014,"New York",8190,21900,392,304,30786
"4106",2014,"North Carolina",1155,15491,465,460,17571
"4107",2014,"North Dakota",1598,5306,62,196,7162
"4108",2014,"Ohio",25552,22111,1495,2578,51736
"4109",2014,"Oklahoma",12353,12430,717,1862,27362
"4110",2014,"Oregon",9939,10701,0,0,20640
"4111",2014,"Pennsylvania",50150,10758,0,0,60908
"4112",2014,"Puerto Rico",1151,195,8,44,1398
"4113",2014,"Rhode Island",907,806,55,220,1988
"4114",2014,"South Carolina",7251,7633,271,600,15755
"4115",2014,"South Dakota",2172,6508,122,302,9104
"4116",2014,"Tennessee",19184,17453,0,1786,38423
"4117",2014,"Texas",39725,44864,2317,5272,92178
"4118",2014,"Utah",2335,4064,83,310,6792
"4119",2014,"Vermont",1130,1853,57,116,3156
"4120",2014,"Virgin Islands",27,1,0,0,28
"4121",2014,"Virginia",18009,17273,934,0,36216
"4122",2014,"Washington",13942,12017,1205,1168,28332
"4123",2014,"West Virginia",6080,9459,178,970,16687
"4124",2014,"Wisconsin",10459,16475,456,82,27472
"4125",2014,"Wyoming",1597,2630,56,226,4509
"4126",2014,"Alabama",12337,13130,456,1442,27365
"4127",2014,"Alaska",2416,3273,120,340,6149
"4128",2014,"Arizona",8689,7451,606,1040,17786
"4129",2014,"Arkansas",4074,6480,115,698,11367
"4130",2014,"California",37720,28503,3278,0,69501
"4131",2014,"Colorado",13033,12658,639,1798,28128
"4132",2014,"Connecticut",7785,3660,144,0,11589
"4133",2014,"Delaware",1370,1688,45,116,3219
"4134",2014,"District of Columbia",47,1,0,0,48
"4135",2014,"Florida",37253,21661,1791,3444,64149
"4136",2014,"Georgia",9973,9497,294,1036,20800
"4137",2014,"Guam",86,44,47,8,185
"4138",2014,"Hawaii",0,0,0,0,0
"4139",2014,"Idaho",2367,4956,69,348,7740
"4140",2014,"Illinois",16060,12191,0,1642,29893
"4141",2014,"Indiana",13876,12326,647,1230,28079
"4142",2014,"Iowa",178,2660,23,8,2869
"4143",2014,"Kansas",3935,5343,187,526,9991
"4144",2014,"Kentucky",6912,8077,183,996,16168
"4145",2014,"Louisiana",11352,16638,518,1638,30146
"4146",2014,"Maine",2440,4596,120,342,7498
"4147",2014,"Mariana Islands",0,2,0,0,2
"4148",2014,"Maryland",2282,4797,87,26,7192
"4149",2014,"Massachusetts",4098,2420,254,258,7030
"4150",2014,"Michigan",7668,12051,242,358,20319
"4151",2014,"Minnesota",6621,15768,375,606,23370
"4152",2014,"Mississippi",7427,8847,190,852,17316
"4153",2014,"Missouri",14837,14838,646,1782,32103
"4154",2014,"Montana",2562,5273,76,438,8349
"4155",2014,"Nebraska",90,2156,13,12,2271
"4156",2014,"Nevada",3517,2803,153,488,6961
"4157",2014,"New Hampshire",3466,3192,67,4,6729
"4158",2014,"New Jersey",3492,2854,124,0,6470
"4159",2014,"New Mexico",4080,4168,203,488,8939
"4160",2014,"New York",7350,16835,455,250,24890
"4161",2014,"North Carolina",926,12314,364,404,14008
"4162",2014,"North Dakota",1389,3798,49,174,5410
"4163",2014,"Ohio",20852,17783,912,2132,41679
"4164",2014,"Oklahoma",10040,10567,573,1754,22934
"4165",2014,"Oregon",9089,10389,0,0,19478
"4166",2014,"Pennsylvania",42506,8823,0,0,51329
"4167",2014,"Puerto Rico",1018,224,11,52,1305
"4168",2014,"Rhode Island",779,627,49,210,1665
"4169",2014,"South Carolina",6192,6127,253,594,13166
"4170",2014,"South Dakota",2006,4479,109,312,6906
"4171",2014,"Tennessee",16841,14442,0,1610,32893
"4172",2014,"Texas",34837,46899,1949,4752,88437
"4173",2014,"Utah",2458,4059,90,288,6895
"4174",2014,"Vermont",1033,1604,45,114,2796
"4175",2014,"Virgin Islands",8,4,0,0,12
"4176",2014,"Virginia",16028,14835,754,0,31617
"4177",2014,"Washington",11366,10589,919,1064,23938
"4178",2014,"West Virginia",5203,7365,189,850,13607
"4179",2014,"Wisconsin",9224,13579,412,62,23277
"4180",2014,"Wyoming",1514,2483,53,194,4244
"4181",2014,"Alabama",13082,11806,504,1562,26954
"4182",2014,"Alaska",2923,3852,143,462,7380
"4183",2014,"Arizona",9189,7159,616,1000,17964
"4184",2014,"Arkansas",4075,5296,102,600,10073
"4185",2014,"California",38710,30590,3454,0,72754
"4186",2014,"Colorado",14088,12531,639,1816,29074
"4187",2014,"Connecticut",6001,2553,77,0,8631
"4188",2014,"Delaware",1427,1623,53,106,3209
"4189",2014,"District of Columbia",44,3,0,0,47
"4190",2014,"Florida",37260,19794,2009,3298,62361
"4191",2014,"Georgia",10608,8358,291,1004,20261
"4192",2014,"Guam",82,47,29,8,166
"4193",2014,"Hawaii",0,0,0,0,0
"4194",2014,"Idaho",2298,3968,97,328,6691
"4195",2014,"Illinois",16532,12191,0,1432,30155
"4196",2014,"Indiana",15459,12168,662,1080,29369
"4197",2014,"Iowa",117,2205,18,6,2346
"4198",2014,"Kansas",3930,4968,201,608,9707
"4199",2014,"Kentucky",7230,7382,155,1116,15883
"4200",2014,"Louisiana",10024,10791,575,1178,22568
"4201",2014,"Maine",2299,3387,113,274,6073
"4202",2014,"Mariana Islands",0,0,0,0,0
"4203",2014,"Maryland",2393,4587,62,20,7062
"4204",2014,"Massachusetts",4868,2726,320,362,8276
"4205",2014,"Michigan",7886,9867,267,344,18364
"4206",2014,"Minnesota",6595,11540,378,654,19167
"4207",2014,"Mississippi",5690,6078,176,628,12572
"4208",2014,"Missouri",17329,14418,677,2030,34454
"4209",2014,"Montana",2712,4427,68,456,7663
"4210",2014,"Nebraska",81,1878,8,8,1975
"4211",2014,"Nevada",3749,2720,189,536,7194
"4212",2014,"New Hampshire",3616,3162,74,4,6856
"4213",2014,"New Jersey",3653,3035,140,0,6828
"4214",2014,"New Mexico",4498,3949,205,520,9172
"4215",2014,"New York",7025,13388,415,248,21076
"4216",2014,"North Carolina",930,12038,448,492,13908
"4217",2014,"North Dakota",1353,2979,49,158,4539
"4218",2014,"Ohio",20742,16787,939,2062,40530
"4219",2014,"Oklahoma",10714,9635,600,1756,22705
"4220",2014,"Oregon",8476,8157,0,0,16633
"4221",2014,"Pennsylvania",40384,8958,0,0,49342
"4222",2014,"Puerto Rico",1078,256,8,62,1404
"4223",2014,"Rhode Island",790,683,37,200,1710
"4224",2014,"South Carolina",6621,5989,329,570,13509
"4225",2014,"South Dakota",1972,3693,72,272,6009
"4226",2014,"Tennessee",17136,14233,0,1724,33093
"4227",2014,"Texas",38172,43507,2309,4674,88662
"4228",2014,"Utah",2364,3132,87,246,5829
"4229",2014,"Vermont",1020,1177,30,94,2321
"4230",2014,"Virgin Islands",11,1,0,2,14
"4231",2014,"Virginia",16034,13675,792,0,30501
"4232",2014,"Washington",11570,9239,867,976,22652
"4233",2014,"West Virginia",5236,5986,180,760,12162
"4234",2014,"Wisconsin",8526,11849,388,70,20833
"4235",2014,"Wyoming",1517,1964,46,166,3693
"4236",2014,"Alabama",11554,9544,492,1200,22790
"4237",2014,"Alaska",2565,2564,109,260,5498
"4238",2014,"Arizona",8216,5610,557,906,15289
"4239",2014,"Arkansas",3668,3928,133,490,8219
"4240",2014,"California",34912,24482,3254,0,62648
"4241",2014,"Colorado",13288,10489,627,1576,25980
"4242",2014,"Connecticut",4141,1489,92,0,5722
"4243",2014,"Delaware",1301,1333,64,122,2820
"4244",2014,"District of Columbia",44,4,0,2,50
"4245",2014,"Florida",33878,17356,1737,2838,55809
"4246",2014,"Georgia",8998,5971,261,856,16086
"4247",2014,"Guam",72,38,12,8,130
"4248",2014,"Hawaii",0,0,0,0,0
"4249",2014,"Idaho",1970,2823,81,264,5138
"4250",2014,"Illinois",15798,9607,0,1374,26779
"4251",2014,"Indiana",13475,9126,555,942,24098
"4252",2014,"Iowa",119,1606,14,4,1743
"4253",2014,"Kansas",3884,3623,201,422,8130
"4254",2014,"Kentucky",6375,5428,151,968,12922
"4255",2014,"Louisiana",7931,7199,489,854,16473
"4256",2014,"Maine",1995,2381,101,248,4725
"4257",2014,"Mariana Islands",0,2,0,0,2
"4258",2014,"Maryland",1953,3534,91,22,5600
"4259",2014,"Massachusetts",3922,2154,292,236,6604
"4260",2014,"Michigan",7133,6479,228,282,14122
"4261",2014,"Minnesota",6012,7192,285,474,13963
"4262",2014,"Mississippi",4733,3874,133,518,9258
"4263",2014,"Missouri",12678,9729,570,1364,24341
"4264",2014,"Montana",2111,3279,73,364,5827
"4265",2014,"Nebraska",75,1241,10,8,1334
"4266",2014,"Nevada",3359,2279,209,428,6275
"4267",2014,"New Hampshire",3126,2456,61,0,5643
"4268",2014,"New Jersey",3989,2681,122,0,6792
"4269",2014,"New Mexico",3803,3193,230,498,7724
"4270",2014,"New York",7428,9573,338,180,17519
"4271",2014,"North Carolina",787,8442,392,382,10003
"4272",2014,"North Dakota",1150,2145,48,146,3489
"4273",2014,"Ohio",19770,14202,1000,1750,36722
"4274",2014,"Oklahoma",9523,7517,644,1538,19222
"4275",2014,"Oregon",7888,6998,0,0,14886
"4276",2014,"Pennsylvania",34544,6543,0,0,41087
"4277",2014,"Puerto Rico",950,214,9,54,1227
"4278",2014,"Rhode Island",686,564,31,170,1451
"4279",2014,"South Carolina",5453,4095,294,542,10384
"4280",2014,"South Dakota",1816,2559,134,230,4739
"4281",2014,"Tennessee",15442,10414,0,1402,27258
"4282",2014,"Texas",32736,28145,2088,4086,67055
"4283",2014,"Utah",1990,2532,69,218,4809
"4284",2014,"Vermont",916,888,34,60,1898
"4285",2014,"Virgin Islands",13,7,0,0,20
"4286",2014,"Virginia",15727,11605,699,0,28031
"4287",2014,"Washington",10715,7606,839,952,20112
"4288",2014,"West Virginia",4847,4587,163,650,10247
"4289",2014,"Wisconsin",7883,7746,364,80,16073
"4290",2014,"Wyoming",1425,1691,65,178,3359
"4291",2014,"Alabama",11437,10279,417,1136,23269
"4292",2014,"Alaska",2627,2467,130,310,5534
"4293",2014,"Arizona",8507,5496,590,912,15505
"4294",2014,"Arkansas",3859,3788,98,462,8207
"4295",2014,"California",34232,24557,3818,0,62607
"4296",2014,"Colorado",12549,9343,600,1440,23932
"4297",2014,"Connecticut",4293,1647,70,0,6010
"4298",2014,"Delaware",1451,1146,62,126,2785
"4299",2014,"District of Columbia",21,1,0,0,22
"4300",2014,"Florida",33636,17047,1569,2806,55058
"4301",2014,"Georgia",9625,6006,216,684,16531
"4302",2014,"Guam",84,42,13,12,151
"4303",2014,"Hawaii",0,0,0,0,0
"4304",2014,"Idaho",2220,3190,105,256,5771
"4305",2014,"Illinois",15406,8740,0,1140,25286
"4306",2014,"Indiana",13069,8702,530,830,23131
"4307",2014,"Iowa",146,1614,18,8,1786
"4308",2014,"Kansas",3682,3604,172,438,7896
"4309",2014,"Kentucky",6061,5196,157,774,12188
"4310",2014,"Louisiana",9220,6868,546,880,17514
"4311",2014,"Maine",2065,2185,95,220,4565
"4312",2014,"Mariana Islands",0,1,0,0,1
"4313",2014,"Maryland",2383,3641,91,30,6145
"4314",2014,"Massachusetts",4060,2021,305,246,6632
"4315",2014,"Michigan",7041,6044,242,278,13605
"4316",2014,"Minnesota",6592,6796,288,546,14222
"4317",2014,"Mississippi",4596,3664,138,470,8868
"4318",2014,"Missouri",13225,9673,584,1376,24858
"4319",2014,"Montana",2469,3630,73,372,6544
"4320",2014,"Nebraska",89,1144,4,6,1243
"4321",2014,"Nevada",3695,2418,189,440,6742
"4322",2014,"New Hampshire",3214,2561,54,0,5829
"4323",2014,"New Jersey",4018,2493,138,0,6649
"4324",2014,"New Mexico",4237,3269,208,440,8154
"4325",2014,"New York",6991,9201,343,246,16781
"4326",2014,"North Carolina",751,8702,360,396,10209
"4327",2014,"North Dakota",1191,2114,37,124,3466
"4328",2014,"Ohio",18471,13177,947,1680,34275
"4329",2014,"Oklahoma",9705,7568,649,1398,19320
"4330",2014,"Oregon",8731,7689,0,0,16420
"4331",2014,"Pennsylvania",33261,6077,0,0,39338
"4332",2014,"Puerto Rico",930,204,16,38,1188
"4333",2014,"Rhode Island",657,487,26,150,1320
"4334",2014,"South Carolina",5911,3745,260,430,10346
"4335",2014,"South Dakota",1794,2468,73,268,4603
"4336",2014,"Tennessee",14563,10004,0,1326,25893
"4337",2014,"Texas",34426,27426,2067,3596,67515
"4338",2014,"Utah",2182,2654,100,200,5136
"4339",2014,"Vermont",867,787,48,64,1766
"4340",2014,"Virgin Islands",19,2,0,2,23
"4341",2014,"Virginia",14711,11017,623,0,26351
"4342",2014,"Washington",11690,8253,825,912,21680
"4343",2014,"West Virginia",4786,4290,148,610,9834
"4344",2014,"Wisconsin",7922,7111,349,72,15454
"4345",2014,"Wyoming",1503,1774,76,184,3537
"4346",2014,"Alabama",12872,8807,502,1240,23421
"4347",2014,"Alaska",2990,3161,139,374,6664
"4348",2014,"Arizona",9112,6065,582,870,16629
"4349",2014,"Arkansas",3931,3869,102,504,8406
"4350",2014,"California",38192,26630,3879,0,68701
"4351",2014,"Colorado",13775,10818,693,1726,27012
"4352",2014,"Connecticut",4837,1900,68,0,6805
"4353",2014,"Delaware",1790,1671,61,112,3634
"4354",2014,"District of Columbia",29,2,0,0,31
"4355",2014,"Florida",35254,17504,1756,3036,57550
"4356",2014,"Georgia",10127,6051,301,808,17287
"4357",2014,"Guam",77,58,22,18,175
"4358",2014,"Hawaii",0,0,0,0,0
"4359",2014,"Idaho",2436,3399,91,302,6228
"4360",2014,"Illinois",17848,9308,0,1300,28456
"4361",2014,"Indiana",15395,9454,677,1194,26720
"4362",2014,"Iowa",120,1659,19,12,1810
"4363",2014,"Kansas",4155,3779,213,518,8665
"4364",2014,"Kentucky",6668,5294,160,890,13012
"4365",2014,"Louisiana",9196,6921,429,1022,17568
"4366",2014,"Maine",2546,2571,86,268,5471
"4367",2014,"Mariana Islands",0,0,0,0,0
"4368",2014,"Maryland",2532,3877,69,30,6508
"4369",2014,"Massachusetts",4713,2294,293,332,7632
"4370",2014,"Michigan",8422,6988,299,320,16029
"4371",2014,"Minnesota",7285,7633,332,590,15840
"4372",2014,"Mississippi",5337,3706,146,490,9679
"4373",2014,"Missouri",14385,9810,590,1498,26283
"4374",2014,"Montana",2516,3735,80,414,6745
"4375",2014,"Nebraska",107,1323,12,2,1444
"4376",2014,"Nevada",3740,2535,217,518,7010
"4377",2014,"New Hampshire",3831,2802,61,2,6696
"4378",2014,"New Jersey",4856,2871,181,0,7908
"4379",2014,"New Mexico",4577,3520,270,502,8869
"4380",2014,"New York",8008,10682,444,222,19356
"4381",2014,"North Carolina",767,8557,394,432,10150
"4382",2014,"North Dakota",1496,2549,59,164,4268
"4383",2014,"Ohio",21891,14553,1013,2060,39517
"4384",2014,"Oklahoma",9927,7324,684,1536,19471
"4385",2014,"Oregon",9636,8199,0,0,17835
"4386",2014,"Pennsylvania",38001,6871,0,0,44872
"4387",2014,"Puerto Rico",1084,232,5,56,1377
"4388",2014,"Rhode Island",745,592,35,182,1554
"4389",2014,"South Carolina",6444,3875,310,440,11069
"4390",2014,"South Dakota",1992,2659,71,254,4976
"4391",2014,"Tennessee",15607,10039,0,1444,27090
"4392",2014,"Texas",37264,29032,2209,4054,72559
"4393",2014,"Utah",2454,2854,98,208,5614
"4394",2014,"Vermont",977,1014,62,88,2141
"4395",2014,"Virgin Islands",8,3,0,2,13
"4396",2014,"Virginia",15597,11102,686,0,27385
"4397",2014,"Washington",12517,8554,907,942,22920
"4398",2014,"West Virginia",5563,4878,186,790,11417
"4399",2014,"Wisconsin",9269,8182,415,100,17966
"4400",2014,"Wyoming",1732,1972,68,224,3996
"4401",2014,"Alabama",13842,10285,571,1256,25954
"4402",2014,"Alaska",3293,3805,246,408,7752
"4403",2014,"Arizona",10229,6786,644,986,18645
"4404",2014,"Arkansas",4509,4705,137,540,9891
"4405",2014,"California",40847,29602,4030,0,74479
"4406",2014,"Colorado",14888,11741,793,1694,29116
"4407",2014,"Connecticut",4885,2714,75,0,7674
"4408",2014,"Delaware",1449,957,62,126,2594
"4409",2014,"District of Columbia",29,5,0,4,38
"4410",2014,"Florida",37470,19213,1728,2952,61363
"4411",2014,"Georgia",10794,6894,318,736,18742
"4412",2014,"Guam",107,64,31,14,216
"4413",2014,"Hawaii",0,0,0,0,0
"4414",2014,"Idaho",2524,3506,103,272,6405
"4415",2014,"Illinois",21131,11333,0,1452,33916
"4416",2014,"Indiana",16956,11235,801,1142,30134
"4417",2014,"Iowa",183,2379,17,8,2587
"4418",2014,"Kansas",4961,4849,290,510,10610
"4419",2014,"Kentucky",7460,6916,148,878,15402
"4420",2014,"Louisiana",9614,7205,510,928,18257
"4421",2014,"Maine",3028,3280,117,302,6727
"4422",2014,"Mariana Islands",0,2,0,0,2
"4423",2014,"Maryland",4065,4397,51,22,8535
"4424",2014,"Massachusetts",5277,2791,434,356,8858
"4425",2014,"Michigan",10199,8974,324,382,19879
"4426",2014,"Minnesota",9635,11501,422,742,22300
"4427",2014,"Mississippi",5471,4232,177,568,10448
"4428",2014,"Missouri",16394,13060,697,1662,31813
"4429",2014,"Montana",2846,4260,104,496,7706
"4430",2014,"Nebraska",114,1530,20,8,1672
"4431",2014,"Nevada",4030,2969,223,410,7632
"4432",2014,"New Hampshire",4324,3113,93,6,7536
"4433",2014,"New Jersey",5108,3208,156,0,8472
"4434",2014,"New Mexico",4751,3793,258,422,9224
"4435",2014,"New York",8812,14214,682,318,24026
"4436",2014,"North Carolina",899,9966,496,314,11675
"4437",2014,"North Dakota",1931,3158,62,212,5363
"4438",2014,"Ohio",26196,18183,1228,2322,47929
"4439",2014,"Oklahoma",11910,9474,827,1572,23783
"4440",2014,"Oregon",10106,9347,0,0,19453
"4441",2014,"Pennsylvania",44546,7942,0,0,52488
"4442",2014,"Puerto Rico",965,183,19,68,1235
"4443",2014,"Rhode Island",846,664,46,196,1752
"4444",2014,"South Carolina",7753,4816,372,506,13447
"4445",2014,"South Dakota",2219,3235,89,354,5897
"4446",2014,"Tennessee",16972,11316,0,1340,29628
"4447",2014,"Texas",38657,30379,2127,4144,75307
"4448",2014,"Utah",2560,3154,110,268,6092
"4449",2014,"Vermont",1485,1527,62,78,3152
"4450",2014,"Virgin Islands",24,0,0,0,24
"4451",2014,"Virginia",17184,13113,740,0,31037
"4452",2014,"Washington",13876,9961,1074,984,25895
"4453",2014,"West Virginia",6345,6087,198,796,13426
"4454",2014,"Wisconsin",12764,12744,510,78,26096
"4455",2014,"Wyoming",2005,2209,77,224,4515
"4456",2014,"Alabama",17289,13141,691,1524,32645
"4457",2014,"Alaska",2886,3330,209,362,6787
"4458",2014,"Arizona",12720,8253,629,1186,22788
"4459",2014,"Arkansas",6054,5924,135,842,12955
"4460",2014,"California",45089,34352,4833,0,84274
"4461",2014,"Colorado",18478,13652,766,1970,34866
"4462",2014,"Connecticut",6563,12310,171,0,19044
"4463",2014,"Delaware",1809,1219,70,180,3278
"4464",2014,"District of Columbia",45,3,0,0,48
"4465",2014,"Florida",42745,23125,1819,3204,70893
"4466",2014,"Georgia",15033,10064,364,1142,26603
"4467",2014,"Guam",105,77,19,8,209
"4468",2014,"Hawaii",0,0,0,0,0
"4469",2014,"Idaho",3166,4346,135,364,8011
"4470",2014,"Illinois",26637,15182,0,2050,43869
"4471",2014,"Indiana",23024,15040,1085,1410,40559
"4472",2014,"Iowa",237,3580,22,12,3851
"4473",2014,"Kansas",6240,6138,291,738,13407
"4474",2014,"Kentucky",10541,8970,216,1014,20741
"4475",2014,"Louisiana",12132,9994,553,1178,23857
"4476",2014,"Maine",3478,3487,158,290,7413
"4477",2014,"Mariana Islands",0,0,0,0,0
"4478",2014,"Maryland",8197,5712,70,18,13997
"4479",2014,"Massachusetts",6794,3607,406,408,11215
"4480",2014,"Michigan",13134,11534,431,514,25613
"4481",2014,"Minnesota",10604,12475,533,818,24430
"4482",2014,"Mississippi",7582,6093,182,622,14479
"4483",2014,"Missouri",20739,15823,876,1810,39248
"4484",2014,"Montana",3307,4683,110,496,8596
"4485",2014,"Nebraska",121,2079,26,8,2234
"4486",2014,"Nevada",4727,3495,305,612,9139
"4487",2014,"New Hampshire",5060,3695,106,2,8863
"4488",2014,"New Jersey",5486,4034,205,0,9725
"4489",2014,"New Mexico",5928,5200,305,638,12071
"4490",2014,"New York",9717,15665,913,316,26611
"4491",2014,"North Carolina",1054,13571,528,454,15607
"4492",2014,"North Dakota",1966,3397,78,214,5655
"4493",2014,"Ohio",32656,21426,1535,2722,58339
"4494",2014,"Oklahoma",13697,11271,801,1696,27465
"4495",2014,"Oregon",12411,11829,0,0,24240
"4496",2014,"Pennsylvania",57940,10351,0,0,68291
"4497",2014,"Puerto Rico",1167,194,4,78,1443
"4498",2014,"Rhode Island",1106,912,51,262,2331
"4499",2014,"South Carolina",10077,6225,451,564,17317
"4500",2014,"South Dakota",2857,4061,105,338,7361
"4501",2014,"Tennessee",19944,15014,0,1796,36754
"4502",2014,"Texas",49169,38758,2453,4986,95366
"4503",2014,"Utah",3322,3888,117,278,7605
"4504",2014,"Vermont",1615,1563,71,110,3359
"4505",2014,"Virgin Islands",17,1,0,0,18
"4506",2014,"Virginia",23015,16781,904,0,40700
"4507",2014,"Washington",16516,12072,1185,1088,30861
"4508",2014,"West Virginia",8542,7716,269,926,17453
"4509",2014,"Wisconsin",14797,15233,581,90,30701
"4510",2014,"Wyoming",2267,2379,82,242,4970
"4511",2014,"Alabama",19710,14439,679,2174,37002
"4512",2014,"Alaska",2697,2652,173,368,5890
"4513",2014,"Arizona",13149,8294,631,1498,23572
"4514",2014,"Arkansas",7312,7375,127,1324,16138
"4515",2014,"California",39048,29728,4280,0,73056
"4516",2014,"Colorado",17215,13037,661,2110,33023
"4517",2014,"Connecticut",5246,11351,149,0,16746
"4518",2014,"Delaware",1660,1022,95,178,2955
"4519",2014,"District of Columbia",25,2,0,2,29
"4520",2014,"Florida",46802,25174,1614,4016,77606
"4521",2014,"Georgia",17171,10809,355,2082,30417
"4522",2014,"Guam",88,46,23,2,159
"4523",2014,"Hawaii",0,0,0,0,0
"4524",2014,"Idaho",3263,4333,136,558,8290
"4525",2014,"Illinois",23448,13449,0,1980,38877
"4526",2014,"Indiana",22970,14166,904,1544,39584
"4527",2014,"Iowa",206,2939,27,14,3186
"4528",2014,"Kansas",7199,6496,313,1042,15050
"4529",2014,"Kentucky",13082,10425,214,2314,26035
"4530",2014,"Louisiana",13147,10479,467,1396,25489
"4531",2014,"Maine",3221,3082,156,354,6813
"4532",2014,"Mariana Islands",0,1,0,0,1
"4533",2014,"Maryland",10156,5446,47,24,15673
"4534",2014,"Massachusetts",5471,2679,346,322,8818
"4535",2014,"Michigan",11886,9984,352,484,22706
"4536",2014,"Minnesota",8845,9013,437,708,19003
"4537",2014,"Mississippi",9222,6691,199,1034,17146
"4538",2014,"Missouri",21678,16291,825,2622,41416
"4539",2014,"Montana",2798,4003,117,674,7592
"4540",2014,"Nebraska",113,2129,16,8,2266
"4541",2014,"Nevada",5089,3284,210,646,9229
"4542",2014,"New Hampshire",4270,3080,89,8,7447
"4543",2014,"New Jersey",4327,3290,145,0,7762
"4544",2014,"New Mexico",5979,4999,271,694,11943
"4545",2014,"New York",8553,13614,731,298,23196
"4546",2014,"North Carolina",1082,15014,504,978,17578
"4547",2014,"North Dakota",1910,2814,62,208,4994
"4548",2014,"Ohio",32864,19732,1373,3414,57383
"4549",2014,"Oklahoma",15122,11260,740,2420,29542
"4550",2014,"Oregon",12334,10825,0,0,23159
"4551",2014,"Pennsylvania",47511,10231,0,0,57742
"4552",2014,"Puerto Rico",1140,182,15,66,1403
"4553",2014,"Rhode Island",996,718,31,282,2027
"4554",2014,"South Carolina",11484,6181,281,956,18902
"4555",2014,"South Dakota",3008,4013,92,434,7547
"4556",2014,"Tennessee",25694,17965,0,2398,46057
"4557",2014,"Texas",55417,41550,2271,7220,106458
"4558",2014,"Utah",3584,3976,85,386,8031
"4559",2014,"Vermont",1662,1337,68,122,3189
"4560",2014,"Virgin Islands",17,3,0,0,20
"4561",2014,"Virginia",24248,16694,1131,0,42073
"4562",2014,"Washington",15785,12011,1248,1508,30552
"4563",2014,"West Virginia",8737,7936,241,1726,18640
"4564",2014,"Wisconsin",13860,11750,451,134,26195
"4565",2014,"Wyoming",2187,2231,73,262,4753
"4566",2014,"Alabama",12371,12790,579,1166,26906
"4567",2014,"Alaska",1994,2128,202,260,4584
"4568",2014,"Arizona",9833,7135,563,870,18401
"4569",2014,"Arkansas",4337,5573,112,530,10552
"4570",2014,"California",33834,27585,3822,0,65241
"4571",2014,"Colorado",14078,11498,678,1568,27822
"4572",2014,"Connecticut",5330,6693,119,0,12142
"4573",2014,"Delaware",1325,943,80,118,2466
"4574",2014,"District of Columbia",48,3,0,2,53
"4575",2014,"Florida",37372,22370,1671,3038,64451
"4576",2014,"Georgia",9861,8510,303,836,19510
"4577",2014,"Guam",91,52,30,0,173
"4578",2014,"Hawaii",0,0,0,0,0
"4579",2014,"Idaho",2265,3193,113,288,5859
"4580",2014,"Illinois",20164,11190,0,1568,32922
"4581",2014,"Indiana",14854,10418,908,1050,27230
"4582",2014,"Iowa",214,2413,24,2,2653
"4583",2014,"Kansas",5257,5907,247,602,12013
"4584",2014,"Kentucky",7116,6657,200,878,14851
"4585",2014,"Louisiana",9395,10294,495,836,21020
"4586",2014,"Maine",2476,2616,122,276,5490
"4587",2014,"Mariana Islands",0,0,0,0,0
"4588",2014,"Maryland",13512,4859,35,12,18418
"4589",2014,"Massachusetts",5374,2727,367,274,8742
"4590",2014,"Michigan",7388,7414,355,306,15463
"4591",2014,"Minnesota",7500,7101,430,644,15675
"4592",2014,"Mississippi",5347,5946,166,514,11973
"4593",2014,"Missouri",16170,12823,840,1468,31301
"4594",2014,"Montana",2280,3252,75,434,6041
"4595",2014,"Nebraska",93,1966,13,6,2078
"4596",2014,"Nevada",3683,2761,222,522,7188
"4597",2014,"New Hampshire",3767,2830,85,6,6688
"4598",2014,"New Jersey",4461,3337,156,0,7954
"4599",2014,"New Mexico",4256,3940,222,428,8846
"4600",2014,"New York",8356,11964,704,274,21298
"4601",2014,"North Carolina",743,11645,457,418,13263
"4602",2014,"North Dakota",1441,2621,62,172,4296
"4603",2014,"Ohio",21851,14893,1266,1926,39936
"4604",2014,"Oklahoma",11442,10339,763,1524,24068
"4605",2014,"Oregon",10184,9273,0,0,19457
"4606",2014,"Pennsylvania",207,48368,153,0,48728
"4607",2014,"Puerto Rico",1132,215,10,72,1429
"4608",2014,"Rhode Island",802,676,21,282,1781
"4609",2014,"South Carolina",7312,5263,308,528,13411
"4610",2014,"South Dakota",2283,3302,79,282,5946
"4611",2014,"Tennessee",17208,13754,0,1386,32348
"4612",2014,"Texas",39174,36808,2083,4038,82103
"4613",2014,"Utah",2583,3106,117,210,6016
"4614",2014,"Vermont",971,1067,53,90,2181
"4615",2014,"Virgin Islands",18,2,0,0,20
"4616",2014,"Virginia",16759,14172,716,0,31647
"4617",2014,"Washington",13899,10505,1085,1112,26601
"4618",2014,"West Virginia",5748,5726,233,678,12385
"4619",2014,"Wisconsin",9720,8491,472,84,18767
"4620",2014,"Wyoming",1504,1816,87,164,3571
"4621",2013,"Alabama",20186,30523,738,1852,53299
"4622",2013,"Alaska",3036,4064,193,410,7703
"4623",2013,"Arizona",13122,12723,632,1148,27625
"4624",2013,"Arkansas",6292,13463,123,666,20544
"4625",2013,"California",34360,70609,68,0,105037
"4626",2013,"Colorado",18259,20072,807,1950,41088
"4627",2013,"Connecticut",5120,4206,162,0,9488
"4628",2013,"Delaware",1618,1871,97,106,3692
"4629",2013,"District of Columbia",32,3,0,0,35
"4630",2013,"Florida",44668,38782,1742,3780,88972
"4631",2013,"Georgia",16043,22996,347,1298,40684
"4632",2013,"Guam",71,49,16,10,146
"4633",2013,"Hawaii",0,0,0,0,0
"4634",2013,"Idaho",3677,6904,140,400,11121
"4635",2013,"Illinois",23671,19326,0,2120,45117
"4636",2013,"Indiana",20168,21557,841,1556,44122
"4637",2013,"Iowa",217,5671,17,12,5917
"4638",2013,"Kansas",6785,11288,270,804,19147
"4639",2013,"Kentucky",11500,17782,251,1198,30731
"4640",2013,"Louisiana",14000,25519,522,1436,41477
"4641",2013,"Maine",2798,4518,114,292,7722
"4642",2013,"Mariana Islands",0,2,0,0,2
"4643",2013,"Maryland",10340,8061,52,0,18453
"4644",2013,"Massachusetts",5005,3082,345,280,8712
"4645",2013,"Michigan",9884,16140,361,446,26831
"4646",2013,"Minnesota",8191,12738,452,670,22051
"4647",2013,"Mississippi",8172,17156,192,858,26378
"4648",2013,"Missouri",20002,24195,813,1722,46732
"4649",2013,"Montana",3282,6369,81,456,10188
"4650",2013,"Nebraska",157,4419,13,10,4599
"4651",2013,"Nevada",5141,4866,222,684,10913
"4652",2013,"New Hampshire",4472,3985,74,6,8537
"4653",2013,"New Jersey",4332,4632,154,0,9118
"4654",2013,"New Mexico",5833,6878,249,536,13496
"4655",2013,"New York",8013,20786,689,308,29796
"4656",2013,"North Carolina",1171,28667,472,442,30752
"4657",2013,"North Dakota",1823,4293,67,198,6381
"4658",2013,"Ohio",31976,30852,1252,2690,66770
"4659",2013,"Oklahoma",14536,19621,811,2054,37022
"4660",2013,"Oregon",12103,14426,0,0,26529
"4661",2013,"Pennsylvania",20,68271,252,0,68543
"4662",2013,"Puerto Rico",1032,218,11,84,1345
"4663",2013,"Rhode Island",846,904,36,360,2146
"4664",2013,"South Carolina",10335,13522,411,688,24956
"4665",2013,"South Dakota",2749,5832,83,394,9058
"4666",2013,"Tennessee",24107,29742,0,2138,55987
"4667",2013,"Texas",56566,78068,2290,5722,142646
"4668",2013,"Utah",4493,7958,126,326,12903
"4669",2013,"Vermont",1140,1629,63,82,2914
"4670",2013,"Virgin Islands",32,3,0,2,37
"4671",2013,"Virginia",22960,27395,989,0,51344
"4672",2013,"Washington",17123,16363,1167,1058,35711
"4673",2013,"West Virginia",9064,13497,297,936,23794
"4674",2013,"Wisconsin",12457,14499,517,56,27529
"4675",2013,"Wyoming",2439,3363,67,244,6113
"4676",2013,"Alabama",14646,22547,508,1616,39317
"4677",2013,"Alaska",2472,3482,168,364,6486
"4678",2013,"Arizona",10029,10055,526,1068,21678
"4679",2013,"Arkansas",4547,12292,98,738,17675
"4680",2013,"California",31163,43714,84,0,74961
"4681",2013,"Colorado",15843,16429,643,1924,34839
"4682",2013,"Connecticut",4856,3780,78,0,8714
"4683",2013,"Delaware",1335,1809,60,102,3306
"4684",2013,"District of Columbia",29,5,0,2,36
"4685",2013,"Florida",37545,30492,1571,3244,72852
"4686",2013,"Georgia",11071,16419,310,986,28786
"4687",2013,"Guam",55,33,11,8,107
"4688",2013,"Hawaii",0,0,0,0,0
"4689",2013,"Idaho",2493,5285,82,364,8224
"4690",2013,"Illinois",20356,18330,0,1846,40532
"4691",2013,"Indiana",17093,21064,744,1446,40347
"4692",2013,"Iowa",196,5246,22,20,5484
"4693",2013,"Kansas",5534,10120,236,736,16626
"4694",2013,"Kentucky",8074,15492,208,1250,25024
"4695",2013,"Louisiana",9894,20151,426,1216,31687
"4696",2013,"Maine",2363,5048,106,280,7797
"4697",2013,"Mariana Islands",0,5,0,0,5
"4698",2013,"Maryland",7478,8311,45,4,15838
"4699",2013,"Massachusetts",4918,3583,301,324,9126
"4700",2013,"Michigan",8496,18252,257,416,27421
"4701",2013,"Minnesota",7482,14683,326,602,23093
"4702",2013,"Mississippi",5937,14525,166,746,21374
"4703",2013,"Missouri",15610,23535,617,1808,41570
"4704",2013,"Montana",2506,5461,80,444,8491
"4705",2013,"Nebraska",100,3706,11,4,3821
"4706",2013,"Nevada",4165,3962,199,606,8932
"4707",2013,"New Hampshire",3898,3930,53,2,7883
"4708",2013,"New Jersey",4849,5050,132,0,10031
"4709",2013,"New Mexico",4612,5718,210,522,11062
"4710",2013,"New York",7289,22304,530,266,30389
"4711",2013,"North Carolina",858,21936,380,448,23622
"4712",2013,"North Dakota",1499,4459,52,192,6202
"4713",2013,"Ohio",26725,29854,962,2682,60223
"4714",2013,"Oklahoma",12481,17046,769,1858,32154
"4715",2013,"Oregon",10276,12558,0,0,22834
"4716",2013,"Pennsylvania",25,70428,184,0,70637
"4717",2013,"Puerto Rico",1218,235,10,48,1511
"4718",2013,"Rhode Island",865,904,23,242,2034
"4719",2013,"South Carolina",7799,10468,310,590,19167
"4720",2013,"South Dakota",2111,5697,81,294,8183
"4721",2013,"Tennessee",19267,24267,0,1858,45392
"4722",2013,"Texas",43195,57710,1701,5112,107718
"4723",2013,"Utah",3132,6023,103,228,9486
"4724",2013,"Vermont",999,1905,46,112,3062
"4725",2013,"Virgin Islands",12,0,0,0,12
"4726",2013,"Virginia",19170,24822,926,0,44918
"4727",2013,"Washington",13521,14411,901,1072,29905
"4728",2013,"West Virginia",6087,13313,187,906,20493
"4729",2013,"Wisconsin",10913,18644,389,60,30006
"4730",2013,"Wyoming",1802,2772,66,216,4856
"4731",2013,"Alabama",12230,15479,461,1480,29650
"4732",2013,"Alaska",3039,4016,220,504,7779
"4733",2013,"Arizona",8719,7750,483,970,17922
"4734",2013,"Arkansas",3948,8699,73,724,13444
"4735",2013,"California",30693,37814,132,0,68639
"4736",2013,"Colorado",13346,14105,548,1802,29801
"4737",2013,"Connecticut",4324,3224,78,0,7626
"4738",2013,"Delaware",1336,1326,67,156,2885
"4739",2013,"District of Columbia",35,1,1,0,37
"4740",2013,"Florida",34006,23276,1372,2978,61632
"4741",2013,"Georgia",9429,12015,217,1018,22679
"4742",2013,"Guam",66,51,6,6,129
"4743",2013,"Hawaii",0,0,0,0,0
"4744",2013,"Idaho",2190,4920,78,326,7514
"4745",2013,"Illinois",17090,14128,0,1474,32692
"4746",2013,"Indiana",14671,14624,620,1140,31055
"4747",2013,"Iowa",212,3696,24,12,3944
"4748",2013,"Kansas",4983,7034,203,644,12864
"4749",2013,"Kentucky",6821,10102,146,1160,18229
"4750",2013,"Louisiana",8904,15354,397,1120,25775
"4751",2013,"Maine",2664,6369,88,356,9477
"4752",2013,"Mariana Islands",0,2,0,0,2
"4753",2013,"Maryland",13453,5973,81,12,19519
"4754",2013,"Massachusetts",4844,3209,270,270,8593
"4755",2013,"Michigan",8034,14119,251,410,22814
"4756",2013,"Minnesota",7769,17272,328,608,25977
"4757",2013,"Mississippi",5495,8248,154,720,14617
"4758",2013,"Missouri",15300,18695,517,1870,36382
"4759",2013,"Montana",2378,6121,85,470,9054
"4760",2013,"Nebraska",74,2782,19,12,2887
"4761",2013,"Nevada",3873,3221,195,554,7843
"4762",2013,"New Hampshire",3877,3981,45,10,7913
"4763",2013,"New Jersey",5067,4084,190,0,9341
"4764",2013,"New Mexico",4658,4803,230,476,10167
"4765",2013,"New York",7890,19394,516,282,28082
"4766",2013,"North Carolina",737,15688,322,440,17187
"4767",2013,"North Dakota",1406,5451,54,186,7097
"4768",2013,"Ohio",23348,20561,847,2182,46938
"4769",2013,"Oklahoma",9902,11757,536,1646,23841
"4770",2013,"Oregon",9127,10336,0,0,19463
"4771",2013,"Pennsylvania",16,58745,186,0,58947
"4772",2013,"Puerto Rico",1160,275,14,68,1517
"4773",2013,"Rhode Island",863,837,23,264,1987
"4774",2013,"South Carolina",6311,6978,241,526,14056
"4775",2013,"South Dakota",1873,6055,64,248,8240
"4776",2013,"Tennessee",15858,16070,0,1450,33378
"4777",2013,"Texas",36720,44769,1455,4774,87718
"4778",2013,"Utah",2305,3902,72,232,6511
"4779",2013,"Vermont",1040,1820,48,84,2992
"4780",2013,"Virgin Islands",22,1,0,0,23
"4781",2013,"Virginia",17306,18458,859,0,36623
"4782",2013,"Washington",13581,12684,814,1090,28169
"4783",2013,"West Virginia",5791,9447,177,870,16285
"4784",2013,"Wisconsin",11776,17109,414,94,29393
"4785",2013,"Wyoming",1445,2143,51,190,3829
"4786",2013,"Alabama",11406,13077,566,1232,26281
"4787",2013,"Alaska",2152,3073,132,308,5665
"4788",2013,"Arizona",8488,7654,491,744,17377
"4789",2013,"Arkansas",3773,6273,70,582,10698
"4790",2013,"California",27422,39102,75,0,66599
"4791",2013,"Colorado",12795,12751,515,1578,27639
"4792",2013,"Connecticut",4649,3859,62,0,8570
"4793",2013,"Delaware",1106,1075,39,102,2322
"4794",2013,"District of Columbia",33,3,0,0,36
"4795",2013,"Florida",31866,20815,1440,2702,56823
"4796",2013,"Georgia",8385,8957,213,842,18397
"4797",2013,"Guam",53,29,14,4,100
"4798",2013,"Hawaii",0,0,0,0,0
"4799",2013,"Idaho",2136,4609,78,316,7139
"4800",2013,"Illinois",14147,12860,0,1486,28493
"4801",2013,"Indiana",12956,12954,576,1138,27624
"4802",2013,"Iowa",153,3166,20,12,3351
"4803",2013,"Kansas",4069,5993,208,426,10696
"4804",2013,"Kentucky",6237,7751,141,1004,15133
"4805",2013,"Louisiana",10217,15969,419,1290,27895
"4806",2013,"Maine",2613,4902,84,278,7877
"4807",2013,"Mariana Islands",0,1,0,0,1
"4808",2013,"Maryland",38055,9912,221,34,48222
"4809",2013,"Massachusetts",4096,2624,274,248,7242
"4810",2013,"Michigan",7795,13428,275,434,21932
"4811",2013,"Minnesota",7279,16139,313,606,24337
"4812",2013,"Mississippi",4832,6489,134,552,12007
"4813",2013,"Missouri",14101,14257,536,1540,30434
"4814",2013,"Montana",2288,4940,61,424,7713
"4815",2013,"Nebraska",68,2256,9,10,2343
"4816",2013,"Nevada",3358,3109,176,456,7099
"4817",2013,"New Hampshire",3553,3355,46,2,6956
"4818",2013,"New Jersey",4726,3189,176,0,8091
"4819",2013,"New Mexico",3946,4090,176,386,8598
"4820",2013,"New York",7198,16803,688,272,24961
"4821",2013,"North Carolina",578,12550,324,420,13872
"4822",2013,"North Dakota",1466,4170,50,170,5856
"4823",2013,"Ohio",20526,18142,765,1990,41423
"4824",2013,"Oklahoma",8639,9982,503,1494,20618
"4825",2013,"Oregon",8831,10864,0,0,19695
"4826",2013,"Pennsylvania",16,52691,172,0,52879
"4827",2013,"Puerto Rico",1162,269,10,48,1489
"4828",2013,"Rhode Island",759,715,20,250,1744
"4829",2013,"South Carolina",5615,5945,180,482,12222
"4830",2013,"South Dakota",1808,4431,75,296,6610
"4831",2013,"Tennessee",14814,13908,0,1240,29962
"4832",2013,"Texas",33690,45571,1469,4256,84986
"4833",2013,"Utah",2292,3782,44,234,6352
"4834",2013,"Vermont",1093,1553,35,122,2803
"4835",2013,"Virgin Islands",17,3,0,2,22
"4836",2013,"Virginia",15952,16794,761,0,33507
"4837",2013,"Washington",11904,11700,775,972,25351
"4838",2013,"West Virginia",5311,7849,179,788,14127
"4839",2013,"Wisconsin",11423,14573,348,84,26428
"4840",2013,"Wyoming",1533,2336,67,180,4116
"4841",2013,"Alabama",14310,13402,350,1376,29438
"4842",2013,"Alaska",2743,3827,150,356,7076
"4843",2013,"Arizona",9868,8476,457,888,19689
"4844",2013,"Arkansas",4405,6128,73,632,11238
"4845",2013,"California",31020,39974,74,0,71068
"4846",2013,"Colorado",12739,12081,485,1636,26941
"4847",2013,"Connecticut",5169,3252,73,0,8494
"4848",2013,"Delaware",1196,1032,45,104,2377
"4849",2013,"District of Columbia",32,2,0,2,36
"4850",2013,"Florida",35828,20307,1409,3090,60634
"4851",2013,"Georgia",10115,8861,216,992,20184
"4852",2013,"Guam",58,38,20,10,126
"4853",2013,"Hawaii",0,0,0,0,0
"4854",2013,"Idaho",2483,4221,60,324,7088
"4855",2013,"Illinois",16360,12936,0,1380,30676
"4856",2013,"Indiana",14264,12775,597,1098,28734
"4857",2013,"Iowa",223,2519,17,4,2763
"4858",2013,"Kansas",4823,5852,172,552,11399
"4859",2013,"Kentucky",7225,8437,134,1154,16950
"4860",2013,"Louisiana",10247,12044,410,1092,23793
"4861",2013,"Maine",2589,3687,70,258,6604
"4862",2013,"Mariana Islands",0,0,0,0,0
"4863",2013,"Maryland",7716,6779,112,30,14637
"4864",2013,"Massachusetts",4820,3034,365,408,8627
"4865",2013,"Michigan",7767,10728,245,340,19080
"4866",2013,"Minnesota",7706,12119,306,600,20731
"4867",2013,"Mississippi",6169,7080,154,776,14179
"4868",2013,"Missouri",16625,14656,505,1668,33454
"4869",2013,"Montana",3067,4888,108,514,8577
"4870",2013,"Nebraska",92,2088,9,4,2193
"4871",2013,"Nevada",3906,3176,195,508,7785
"4872",2013,"New Hampshire",3823,3191,55,0,7069
"4873",2013,"New Jersey",6036,3631,198,0,9865
"4874",2013,"New Mexico",4583,4243,217,500,9543
"4875",2013,"New York",7552,12961,465,288,21266
"4876",2013,"North Carolina",1125,13357,322,434,15238
"4877",2013,"North Dakota",1390,3155,37,144,4726
"4878",2013,"Ohio",21681,16535,723,2128,41067
"4879",2013,"Oklahoma",11047,10731,469,1606,23853
"4880",2013,"Oregon",9292,9196,0,0,18488
"4881",2013,"Pennsylvania",29,52638,170,0,52837
"4882",2013,"Puerto Rico",1292,209,10,52,1563
"4883",2013,"Rhode Island",827,676,15,232,1750
"4884",2013,"South Carolina",6962,6587,168,576,14293
"4885",2013,"South Dakota",1861,3638,50,236,5785
"4886",2013,"Tennessee",16500,14236,0,1448,32184
"4887",2013,"Texas",38576,45538,1583,4320,90017
"4888",2013,"Utah",2392,3242,54,252,5940
"4889",2013,"Vermont",984,1244,30,94,2352
"4890",2013,"Virgin Islands",20,8,0,0,28
"4891",2013,"Virginia",17394,14938,742,0,33074
"4892",2013,"Washington",13247,11664,847,1032,26790
"4893",2013,"West Virginia",6037,6868,143,766,13814
"4894",2013,"Wisconsin",10107,11966,333,68,22474
"4895",2013,"Wyoming",1736,2241,44,212,4233
"4896",2013,"Alabama",12058,12037,381,1104,25580
"4897",2013,"Alaska",2304,2659,134,308,5405
"4898",2013,"Arizona",8425,6293,430,820,15968
"4899",2013,"Arkansas",4027,4183,63,482,8755
"4900",2013,"California",29531,31564,75,0,61170
"4901",2013,"Colorado",11755,9266,514,1298,22833
"4902",2013,"Connecticut",4649,2497,53,0,7199
"4903",2013,"Delaware",1183,787,49,68,2087
"4904",2013,"District of Columbia",30,1,0,2,33
"4905",2013,"Florida",34204,18664,1334,2730,56932
"4906",2013,"Georgia",8893,6506,231,764,16394
"4907",2013,"Guam",59,44,10,0,113
"4908",2013,"Hawaii",0,0,0,0,0
"4909",2013,"Idaho",1992,2898,75,244,5209
"4910",2013,"Illinois",15986,10383,0,1412,27781
"4911",2013,"Indiana",12316,9385,481,910,23092
"4912",2013,"Iowa",82,1603,10,2,1697
"4913",2013,"Kansas",4830,4368,172,502,9872
"4914",2013,"Kentucky",6395,6133,184,888,13600
"4915",2013,"Louisiana",9017,8014,386,878,18295
"4916",2013,"Maine",2244,2729,73,246,5292
"4917",2013,"Mariana Islands",0,0,0,0,0
"4918",2013,"Maryland",6533,5355,97,36,12021
"4919",2013,"Massachusetts",4283,2289,236,262,7070
"4920",2013,"Michigan",7378,7169,196,314,15057
"4921",2013,"Minnesota",7020,7351,258,440,15069
"4922",2013,"Mississippi",5315,4149,102,488,10054
"4923",2013,"Missouri",14710,10174,446,1256,26586
"4924",2013,"Montana",2393,3445,70,386,6294
"4925",2013,"Nebraska",80,1450,14,4,1548
"4926",2013,"Nevada",3617,2706,178,488,6989
"4927",2013,"New Hampshire",3289,2643,35,0,5967
"4928",2013,"New Jersey",6528,3194,241,0,9963
"4929",2013,"New Mexico",4245,3514,197,600,8556
"4930",2013,"New York",7572,9719,403,206,17900
"4931",2013,"North Carolina",561,9607,293,366,10827
"4932",2013,"North Dakota",1197,2267,32,116,3612
"4933",2013,"Ohio",21099,14667,772,1754,38292
"4934",2013,"Oklahoma",10138,7996,473,1430,20037
"4935",2013,"Oregon",8386,7441,0,0,15827
"4936",2013,"Pennsylvania",19,43118,217,0,43354
"4937",2013,"Puerto Rico",1106,216,10,38,1370
"4938",2013,"Rhode Island",760,638,28,258,1684
"4939",2013,"South Carolina",6074,4428,182,422,11106
"4940",2013,"South Dakota",1675,2555,64,202,4496
"4941",2013,"Tennessee",15367,10932,0,1246,27545
"4942",2013,"Texas",35456,29941,1487,3648,70532
"4943",2013,"Utah",2157,2626,56,232,5071
"4944",2013,"Vermont",862,967,44,84,1957
"4945",2013,"Virgin Islands",24,4,0,2,30
"4946",2013,"Virginia",15759,12570,631,0,28960
"4947",2013,"Washington",11752,9015,641,858,22266
"4948",2013,"West Virginia",5348,5169,132,692,11341
"4949",2013,"Wisconsin",8799,7823,239,36,16897
"4950",2013,"Wyoming",1534,1694,39,156,3423
"4951",2013,"Alabama",11054,10828,349,1098,23329
"4952",2013,"Alaska",2470,2593,154,332,5549
"4953",2013,"Arizona",8716,6413,386,740,16255
"4954",2013,"Arkansas",3966,3974,89,522,8551
"4955",2013,"California",29702,35007,78,0,64787
"4956",2013,"Colorado",16137,13206,658,2204,32205
"4957",2013,"Connecticut",4545,3693,80,0,8318
"4958",2013,"Delaware",1175,862,53,116,2206
"4959",2013,"District of Columbia",25,1,0,0,26
"4960",2013,"Florida",33559,19343,1393,2754,57049
"4961",2013,"Georgia",8591,6541,193,730,16055
"4962",2013,"Guam",44,44,3,8,99
"4963",2013,"Hawaii",0,0,0,0,0
"4964",2013,"Idaho",2109,3188,81,246,5624
"4965",2013,"Illinois",15062,10196,0,1256,26514
"4966",2013,"Indiana",12447,9845,628,938,23858
"4967",2013,"Iowa",74,1713,11,6,1804
"4968",2013,"Kansas",4370,4246,162,510,9288
"4969",2013,"Kentucky",6556,5943,129,800,13428
"4970",2013,"Louisiana",8734,7613,362,808,17517
"4971",2013,"Maine",2427,2712,80,254,5473
"4972",2013,"Mariana Islands",0,0,0,0,0
"4973",2013,"Maryland",6849,5318,290,100,12557
"4974",2013,"Massachusetts",4109,2557,280,296,7242
"4975",2013,"Michigan",7492,7573,237,232,15534
"4976",2013,"Minnesota",7399,7387,260,480,15526
"4977",2013,"Mississippi",4744,3848,111,470,9173
"4978",2013,"Missouri",14577,10444,465,1226,26712
"4979",2013,"Montana",2433,3569,75,378,6455
"4980",2013,"Nebraska",91,1533,19,8,1651
"4981",2013,"Nevada",4043,3125,196,548,7912
"4982",2013,"New Hampshire",3514,2738,33,4,6289
"4983",2013,"New Jersey",7691,3995,418,0,12104
"4984",2013,"New Mexico",4207,3633,195,442,8477
"4985",2013,"New York",7250,10414,453,224,18341
"4986",2013,"North Carolina",594,9733,312,352,10991
"4987",2013,"North Dakota",1249,2483,31,92,3855
"4988",2013,"Ohio",20896,14770,716,1806,38188
"4989",2013,"Oklahoma",9454,7955,445,1290,19144
"4990",2013,"Oregon",9161,8079,0,0,17240
"4991",2013,"Pennsylvania",20,45518,266,0,45804
"4992",2013,"Puerto Rico",1320,251,9,52,1632
"4993",2013,"Rhode Island",868,657,44,250,1819
"4994",2013,"South Carolina",6228,4220,149,392,10989
"4995",2013,"South Dakota",1761,2593,60,208,4622
"4996",2013,"Tennessee",14513,10657,0,1278,26448
"4997",2013,"Texas",34302,30708,1566,3666,70242
"4998",2013,"Utah",2372,2814,67,182,5435
"4999",2013,"Vermont",931,975,30,42,1978
"5000",2013,"Virgin Islands",33,2,0,0,35
"5001",2013,"Virginia",16205,12574,597,0,29376
"5002",2013,"Washington",12717,10015,817,898,24447
"5003",2013,"West Virginia",5304,5374,135,610,11423
"5004",2013,"Wisconsin",8632,7553,336,38,16559
"5005",2013,"Wyoming",1641,1840,54,166,3701
"5006",2013,"Alabama",13221,12165,372,1118,26876
"5007",2013,"Alaska",2856,3569,191,404,7020
"5008",2013,"Arizona",9533,7320,503,788,18144
"5009",2013,"Arkansas",4865,4917,92,564,10438
"5010",2013,"California",31638,37157,71,0,68866
"5011",2013,"Colorado",15666,12799,654,2114,31233
"5012",2013,"Connecticut",4879,3459,85,0,8423
"5013",2013,"Delaware",1476,1017,71,112,2676
"5014",2013,"District of Columbia",35,5,0,0,40
"5015",2013,"Florida",35935,21373,1491,2976,61775
"5016",2013,"Georgia",9563,7116,237,758,17674
"5017",2013,"Guam",58,64,9,6,137
"5018",2013,"Hawaii",0,0,0,0,0
"5019",2013,"Idaho",2470,3417,107,232,6226
"5020",2013,"Illinois",16142,11591,0,1314,29047
"5021",2013,"Indiana",13497,10404,682,936,25519
"5022",2013,"Iowa",78,2016,15,8,2117
"5023",2013,"Kansas",5419,5179,201,576,11375
"5024",2013,"Kentucky",7976,6876,161,1022,16035
"5025",2013,"Louisiana",10087,8985,401,1004,20477
"5026",2013,"Maine",2820,3092,85,254,6251
"5027",2013,"Mariana Islands",0,0,0,0,0
"5028",2013,"Maryland",8507,5470,146,58,14181
"5029",2013,"Massachusetts",4776,2714,429,286,8205
"5030",2013,"Michigan",9056,8443,283,274,18056
"5031",2013,"Minnesota",9637,8787,343,590,19357
"5032",2013,"Mississippi",5369,4787,129,516,10801
"5033",2013,"Missouri",16990,12515,625,1396,31526
"5034",2013,"Montana",2690,4067,111,400,7268
"5035",2013,"Nebraska",83,1638,11,0,1732
"5036",2013,"Nevada",4426,3571,247,630,8874
"5037",2013,"New Hampshire",4051,3086,37,0,7174
"5038",2013,"New Jersey",7726,4486,444,0,12656
"5039",2013,"New Mexico",4686,4267,196,470,9619
"5040",2013,"New York",7992,11417,550,246,20205
"5041",2013,"North Carolina",652,11406,380,298,12736
"5042",2013,"North Dakota",1652,2856,55,118,4681
"5043",2013,"Ohio",23364,15596,849,2068,41877
"5044",2013,"Oklahoma",10401,9045,506,1500,21452
"5045",2013,"Oregon",10027,8727,0,0,18754
"5046",2013,"Pennsylvania",20,49732,265,0,50017
"5047",2013,"Puerto Rico",1297,217,10,62,1586
"5048",2013,"Rhode Island",1036,819,52,400,2307
"5049",2013,"South Carolina",7277,4673,218,512,12680
"5050",2013,"South Dakota",2180,3075,53,244,5552
"5051",2013,"Tennessee",16850,12546,0,1380,30776
"5052",2013,"Texas",41105,34669,1948,4198,81920
"5053",2013,"Utah",2749,3255,96,220,6320
"5054",2013,"Vermont",1030,1112,46,80,2268
"5055",2013,"Virgin Islands",12,2,0,2,16
"5056",2013,"Virginia",17007,13414,687,0,31108
"5057",2013,"Washington",14262,10595,797,934,26588
"5058",2013,"West Virginia",6371,5792,194,762,13119
"5059",2013,"Wisconsin",11961,9200,385,66,21612
"5060",2013,"Wyoming",2066,2174,85,218,4543
"5061",2013,"Alabama",14930,13043,468,1390,29831
"5062",2013,"Alaska",3324,4162,340,418,8244
"5063",2013,"Arizona",11774,8650,748,1052,22224
"5064",2013,"Arkansas",5983,6145,108,598,12834
"5065",2013,"California",34701,42516,72,0,77289
"5066",2013,"Colorado",18548,16004,1047,2570,38169
"5067",2013,"Connecticut",6631,6531,1276,0,14438
"5068",2013,"Delaware",1871,1323,83,144,3421
"5069",2013,"District of Columbia",41,6,0,2,49
"5070",2013,"Florida",41943,25404,2086,3298,72731
"5071",2013,"Georgia",11406,8593,288,964,21251
"5072",2013,"Guam",35,42,12,0,89
"5073",2013,"Hawaii",0,0,0,0,0
"5074",2013,"Idaho",3115,4476,107,290,7988
"5075",2013,"Illinois",18421,14842,0,1794,35057
"5076",2013,"Indiana",17150,14005,787,1132,33074
"5077",2013,"Iowa",120,2947,22,4,3093
"5078",2013,"Kansas",7408,7172,326,756,15662
"5079",2013,"Kentucky",10079,9442,180,1080,20781
"5080",2013,"Louisiana",11514,10078,445,1098,23135
"5081",2013,"Maine",3940,4331,116,404,8791
"5082",2013,"Mariana Islands",0,0,0,0,0
"5083",2013,"Maryland",7924,7231,76,28,15259
"5084",2013,"Massachusetts",5081,3717,478,328,9604
"5085",2013,"Michigan",13166,12695,412,490,26763
"5086",2013,"Minnesota",12801,14244,531,854,28430
"5087",2013,"Mississippi",6469,5482,170,558,12679
"5088",2013,"Missouri",19776,16405,715,1558,38454
"5089",2013,"Montana",3411,5035,110,452,9008
"5090",2013,"Nebraska",103,2383,21,6,2513
"5091",2013,"Nevada",5241,4263,298,724,10526
"5092",2013,"New Hampshire",5292,4088,67,4,9451
"5093",2013,"New Jersey",5032,3645,300,0,8977
"5094",2013,"New Mexico",5204,5096,267,510,11077
"5095",2013,"New York",10237,16789,514,276,27816
"5096",2013,"North Carolina",635,13493,517,330,14975
"5097",2013,"North Dakota",2141,3860,57,238,6296
"5098",2013,"Ohio",31627,21579,1266,2434,56906
"5099",2013,"Oklahoma",13962,11874,751,1536,28123
"5100",2013,"Oregon",12561,11056,0,0,23617
"5101",2013,"Pennsylvania",22,64416,339,0,64777
"5102",2013,"Puerto Rico",1112,160,28,30,1330
"5103",2013,"Rhode Island",1256,1207,77,468,3008
"5104",2013,"South Carolina",9032,6161,292,524,16009
"5105",2013,"South Dakota",2680,3868,78,298,6924
"5106",2013,"Tennessee",19072,14798,0,1568,35438
"5107",2013,"Texas",48822,39216,2164,4572,94774
"5108",2013,"Utah",3690,4183,95,218,8186
"5109",2013,"Vermont",1591,1883,63,142,3679
"5110",2013,"Virgin Islands",19,4,0,0,23
"5111",2013,"Virginia",20989,17416,866,0,39271
"5112",2013,"Washington",17008,13057,1154,1012,32231
"5113",2013,"West Virginia",7548,7408,198,780,15934
"5114",2013,"Wisconsin",14982,15166,604,76,30828
"5115",2013,"Wyoming",2254,2413,117,240,5024
"5116",2013,"Alabama",20215,18498,538,1856,41107
"5117",2013,"Alaska",3506,4228,394,440,8568
"5118",2013,"Arizona",14384,10700,729,1180,26993
"5119",2013,"Arkansas",9312,8667,141,746,18866
"5120",2013,"California",38013,48181,80,0,86274
"5121",2013,"Colorado",23937,20786,1258,3472,49453
"5122",2013,"Connecticut",8010,8128,1165,0,17303
"5123",2013,"Delaware",2243,1755,92,178,4268
"5124",2013,"District of Columbia",48,3,0,2,53
"5125",2013,"Florida",48586,31464,1998,3750,85798
"5126",2013,"Georgia",16404,12878,364,1316,30962
"5127",2013,"Guam",31,41,7,6,85
"5128",2013,"Hawaii",0,0,0,0,0
"5129",2013,"Idaho",4126,5603,155,382,10266
"5130",2013,"Illinois",23779,19564,0,2182,45525
"5131",2013,"Indiana",24239,18379,1055,1688,45361
"5132",2013,"Iowa",195,4400,33,6,4634
"5133",2013,"Kansas",9708,9056,401,884,20049
"5134",2013,"Kentucky",14921,12647,337,1470,29375
"5135",2013,"Louisiana",14463,12844,499,1358,29164
"5136",2013,"Maine",4745,4908,139,516,10308
"5137",2013,"Mariana Islands",0,0,0,0,0
"5138",2013,"Maryland",8217,8190,63,98,16568
"5139",2013,"Massachusetts",6174,4861,496,408,11939
"5140",2013,"Michigan",17749,16343,435,584,35111
"5141",2013,"Minnesota",15176,14763,548,966,31453
"5142",2013,"Mississippi",8752,8146,190,768,17856
"5143",2013,"Missouri",26501,21600,945,2064,51110
"5144",2013,"Montana",4358,5536,122,516,10532
"5145",2013,"Nebraska",134,3020,23,8,3185
"5146",2013,"Nevada",6305,5169,308,838,12620
"5147",2013,"New Hampshire",6519,5004,66,2,11591
"5148",2013,"New Jersey",5369,4219,255,0,9843
"5149",2013,"New Mexico",6870,6126,313,1030,14339
"5150",2013,"New York",12598,18458,605,396,32057
"5151",2013,"North Carolina",936,19162,627,406,21131
"5152",2013,"North Dakota",2735,3882,93,220,6930
"5153",2013,"Ohio",42641,27725,1614,3398,75378
"5154",2013,"Oklahoma",17319,14650,720,1738,34427
"5155",2013,"Oregon",14859,13047,0,0,27906
"5156",2013,"Pennsylvania",43,84244,349,0,84636
"5157",2013,"Puerto Rico",1001,194,10,56,1261
"5158",2013,"Rhode Island",1546,1224,53,530,3353
"5159",2013,"South Carolina",12620,9103,375,784,22882
"5160",2013,"South Dakota",3537,5315,94,424,9370
"5161",2013,"Tennessee",26152,21626,0,1968,49746
"5162",2013,"Texas",64439,49206,2553,5826,122024
"5163",2013,"Utah",5415,5409,121,346,11291
"5164",2013,"Vermont",1899,2044,59,194,4196
"5165",2013,"Virgin Islands",9,8,0,0,17
"5166",2013,"Virginia",28321,22841,1122,0,52284
"5167",2013,"Washington",21189,15283,1303,1280,39055
"5168",2013,"West Virginia",10984,10380,295,1084,22743
"5169",2013,"Wisconsin",18924,18367,557,64,37912
"5170",2013,"Wyoming",3110,2998,118,328,6554
"5171",2013,"Alabama",24166,19763,579,2294,46802
"5172",2013,"Alaska",4011,4073,355,490,8929
"5173",2013,"Arizona",16313,11166,580,1596,29655
"5174",2013,"Arkansas",12200,10228,144,1476,24048
"5175",2013,"California",38087,46026,97,0,84210
"5176",2013,"Colorado",27732,20546,1080,4432,53790
"5177",2013,"Connecticut",6813,6190,652,0,13655
"5178",2013,"Delaware",2358,1658,99,192,4307
"5179",2013,"District of Columbia",58,3,0,2,63
"5180",2013,"Florida",56967,34711,1948,4990,98616
"5181",2013,"Georgia",22516,14256,363,2034,39169
"5182",2013,"Guam",53,38,2,4,97
"5183",2013,"Hawaii",0,0,0,0,0
"5184",2013,"Idaho",5043,5712,128,554,11437
"5185",2013,"Illinois",24175,18387,0,2494,45056
"5186",2013,"Indiana",26643,18179,865,1764,47451
"5187",2013,"Iowa",238,3995,34,16,4283
"5188",2013,"Kansas",11355,9238,320,1192,22105
"5189",2013,"Kentucky",19072,13980,321,2492,35865
"5190",2013,"Louisiana",16804,13560,582,1712,32658
"5191",2013,"Maine",4228,4097,109,428,8862
"5192",2013,"Mariana Islands",0,2,0,0,2
"5193",2013,"Maryland",7965,7786,76,106,15933
"5194",2013,"Massachusetts",5818,3578,513,434,10343
"5195",2013,"Michigan",18279,14848,448,644,34219
"5196",2013,"Minnesota",15779,12716,549,1168,30212
"5197",2013,"Mississippi",11204,9433,238,1086,21961
"5198",2013,"Missouri",30172,21984,830,2700,55686
"5199",2013,"Montana",4766,5232,116,782,10896
"5200",2013,"Nebraska",160,2993,34,8,3195
"5201",2013,"Nevada",7432,5095,538,1032,14097
"5202",2013,"New Hampshire",6214,4434,75,10,10733
"5203",2013,"New Jersey",4472,4274,226,0,8972
"5204",2013,"New Mexico",7396,6328,290,776,14790
"5205",2013,"New York",11469,17235,523,394,29621
"5206",2013,"North Carolina",1085,21728,691,932,24436
"5207",2013,"North Dakota",3143,3764,56,288,7251
"5208",2013,"Ohio",45622,26931,1624,3910,78087
"5209",2013,"Oklahoma",20619,15693,673,2686,39671
"5210",2013,"Oregon",16691,13428,0,0,30119
"5211",2013,"Pennsylvania",26,82258,278,0,82562
"5212",2013,"Puerto Rico",1006,214,21,34,1275
"5213",2013,"Rhode Island",1343,992,43,490,2868
"5214",2013,"South Carolina",16733,9776,444,1150,28103
"5215",2013,"South Dakota",4160,5054,120,488,9822
"5216",2013,"Tennessee",32630,23703,0,2682,59015
"5217",2013,"Texas",76087,52208,2437,7946,138678
"5218",2013,"Utah",6512,5464,154,418,12548
"5219",2013,"Vermont",2140,1961,49,208,4358
"5220",2013,"Virgin Islands",5,1,0,0,6
"5221",2013,"Virginia",32229,23554,1341,0,57124
"5222",2013,"Washington",24333,16360,1208,1738,43639
"5223",2013,"West Virginia",12345,10340,264,1636,24585
"5224",2013,"Wisconsin",20921,15247,496,70,36734
"5225",2013,"Wyoming",3284,2803,96,348,6531
"5226",2013,"Alabama",26630,22168,645,2124,51567
"5227",2013,"Alaska",4765,4255,215,564,9799
"5228",2013,"Arizona",19373,13109,859,1684,35025
"5229",2013,"Arkansas",11566,9868,204,940,22578
"5230",2013,"California",51025,54527,96,0,105648
"5231",2013,"Colorado",26419,19972,761,5280,52432
"5232",2013,"Connecticut",9275,8636,757,0,18668
"5233",2013,"Delaware",2902,1909,109,232,5152
"5234",2013,"District of Columbia",55,4,0,0,59
"5235",2013,"Florida",68294,41844,2047,5748,117933
"5236",2013,"Georgia",23439,14798,383,1602,40222
"5237",2013,"Guam",67,54,6,10,137
"5238",2013,"Hawaii",0,0,0,0,0
"5239",2013,"Idaho",5676,5792,165,494,12127
"5240",2013,"Illinois",31185,22138,0,3128,56451
"5241",2013,"Indiana",30334,20505,1121,2080,54040
"5242",2013,"Iowa",344,4399,68,26,4837
"5243",2013,"Kansas",13924,10878,488,1366,26656
"5244",2013,"Kentucky",17460,13023,448,1582,32513
"5245",2013,"Louisiana",21046,17511,799,1880,41236
"5246",2013,"Maine",5306,4566,173,498,10543
"5247",2013,"Mariana Islands",0,1,0,0,1
"5248",2013,"Maryland",9416,8660,76,38,18190
"5249",2013,"Massachusetts",7295,4810,409,522,13036
"5250",2013,"Michigan",21547,15621,402,726,38296
"5251",2013,"Minnesota",17763,13846,650,1302,33561
"5252",2013,"Mississippi",11296,10927,315,984,23522
"5253",2013,"Missouri",36400,24147,1077,2728,64352
"5254",2013,"Montana",5509,5273,130,620,11532
"5255",2013,"Nebraska",201,3519,35,16,3771
"5256",2013,"Nevada",8354,5865,416,1238,15873
"5257",2013,"New Hampshire",7968,6068,96,6,14138
"5258",2013,"New Jersey",4958,5888,264,0,11110
"5259",2013,"New Mexico",7683,6624,321,816,15444
"5260",2013,"New York",13448,25744,1143,506,40841
"5261",2013,"North Carolina",1282,22157,755,384,24578
"5262",2013,"North Dakota",3893,4222,59,358,8532
"5263",2013,"Ohio",49243,29034,1625,3846,83748
"5264",2013,"Oklahoma",24793,17756,922,2486,45957
"5265",2013,"Oregon",19225,14044,0,0,33269
"5266",2013,"Pennsylvania",61,93619,304,0,93984
"5267",2013,"Puerto Rico",1092,221,16,56,1385
"5268",2013,"Rhode Island",1831,1555,41,730,4157
"5269",2013,"South Carolina",15015,8903,662,958,25538
"5270",2013,"South Dakota",5023,5512,139,504,11178
"5271",2013,"Tennessee",34623,23963,0,2538,61124
"5272",2013,"Texas",89130,60897,3015,7654,160696
"5273",2013,"Utah",8344,5834,161,422,14761
"5274",2013,"Vermont",2203,1810,72,220,4305
"5275",2013,"Virgin Islands",17,8,0,2,27
"5276",2013,"Virginia",34636,24775,1426,0,60837
"5277",2013,"Washington",28505,18241,1252,1556,49554
"5278",2013,"West Virginia",12197,10377,318,1194,24086
"5279",2013,"Wisconsin",25154,15454,593,98,41299
"5280",2013,"Wyoming",3848,2997,99,312,7256
"5281",2012,"Alabama",30614,42433,777,3346,77170
"5282",2012,"Alaska",5179,6304,268,712,12463
"5283",2012,"Arizona",20512,19634,1142,2204,43492
"5284",2012,"Arkansas",11711,19680,246,1174,32811
"5285",2012,"California",51731,73026,91,0,124848
"5286",2012,"Colorado",23511,24846,820,3748,52925
"5287",2012,"Connecticut",8845,9274,712,0,18831
"5288",2012,"Delaware",2621,2747,120,238,5726
"5289",2012,"District of Columbia",50,1,0,0,51
"5290",2012,"Florida",65872,59904,2549,6872,135197
"5291",2012,"Georgia",26035,32774,472,2454,61735
"5292",2012,"Guam",49,55,3,8,115
"5293",2012,"Hawaii",0,0,0,0,0
"5294",2012,"Idaho",6555,10015,248,734,17552
"5295",2012,"Illinois",28548,28820,0,3110,60478
"5296",2012,"Indiana",28474,31940,1357,2886,64657
"5297",2012,"Iowa",235,8121,53,18,8427
"5298",2012,"Kansas",13854,17592,537,1854,33837
"5299",2012,"Kentucky",19442,26550,433,2016,48441
"5300",2012,"Louisiana",21599,33919,765,2398,58681
"5301",2012,"Maine",4916,6755,239,562,12472
"5302",2012,"Mariana Islands",0,0,0,0,0
"5303",2012,"Maryland",7827,11046,57,28,18958
"5304",2012,"Massachusetts",7200,5746,557,716,14219
"5305",2012,"Michigan",7170,26867,492,372,34901
"5306",2012,"Minnesota",13840,19260,824,1412,35336
"5307",2012,"Mississippi",12616,25190,497,1468,39771
"5308",2012,"Missouri",35516,36872,1448,3358,77194
"5309",2012,"Montana",6287,8919,187,824,16217
"5310",2012,"Nebraska",224,6715,30,20,6989
"5311",2012,"Nevada",9274,9429,450,1498,20651
"5312",2012,"New Hampshire",8412,7366,135,4,15917
"5313",2012,"New Jersey",3825,5947,275,0,10047
"5314",2012,"New Mexico",8477,10310,428,1106,20321
"5315",2012,"New York",9489,34876,1212,578,46155
"5316",2012,"North Carolina",1234,41758,773,508,44273
"5317",2012,"North Dakota",3551,6324,71,404,10350
"5318",2012,"Ohio",48667,47197,2002,4976,102842
"5319",2012,"Oklahoma",25216,29041,1171,3568,58996
"5320",2012,"Oregon",21566,22599,0,0,44165
"5321",2012,"Pennsylvania",78,105826,319,0,106223
"5322",2012,"Puerto Rico",1458,262,23,60,1803
"5323",2012,"Rhode Island",1631,1865,40,668,4204
"5324",2012,"South Carolina",16842,18436,661,1248,37187
"5325",2012,"South Dakota",5079,8910,120,682,14791
"5326",2012,"Tennessee",37951,43721,0,3642,85314
"5327",2012,"Texas",98886,108058,3699,10586,221229
"5328",2012,"Utah",9885,12126,234,584,22829
"5329",2012,"Vermont",2001,2622,92,260,4975
"5330",2012,"Virgin Islands",20,6,0,6,32
"5331",2012,"Virginia",36554,39104,1829,0,77487
"5332",2012,"Washington",27035,28335,2004,1972,59346
"5333",2012,"West Virginia",12009,18169,335,1394,31907
"5334",2012,"Wisconsin",22343,22451,803,74,45671
"5335",2012,"Wyoming",4157,4722,117,526,9522
"5336",2012,"Alabama",17207,27326,518,2194,47245
"5337",2012,"Alaska",3136,4182,250,450,8018
"5338",2012,"Arizona",12968,12975,587,1454,27984
"5339",2012,"Arkansas",6340,14554,145,910,21949
"5340",2012,"California",35855,49929,74,0,85858
"5341",2012,"Colorado",19733,21463,633,2712,44541
"5342",2012,"Connecticut",5819,6571,324,0,12714
"5343",2012,"Delaware",1544,1989,60,128,3721
"5344",2012,"District of Columbia",37,3,0,2,42
"5345",2012,"Florida",43550,37856,1653,4374,87433
"5346",2012,"Georgia",13482,19167,295,1498,34442
"5347",2012,"Guam",35,39,4,8,86
"5348",2012,"Hawaii",0,0,0,0,0
"5349",2012,"Idaho",3360,6640,137,518,10655
"5350",2012,"Illinois",16845,22364,0,2300,41509
"5351",2012,"Indiana",17383,24331,899,1754,44367
"5352",2012,"Iowa",157,7217,24,6,7404
"5353",2012,"Kansas",8330,12794,376,1146,22646
"5354",2012,"Kentucky",10571,17789,255,1594,30209
"5355",2012,"Louisiana",11882,22676,499,1564,36621
"5356",2012,"Maine",3024,5425,128,448,9025
"5357",2012,"Mariana Islands",0,0,0,0,0
"5358",2012,"Maryland",7141,9488,33,44,16706
"5359",2012,"Massachusetts",4870,4149,350,398,9767
"5360",2012,"Michigan",1453,22403,286,76,24218
"5361",2012,"Minnesota",8820,15392,418,784,25414
"5362",2012,"Mississippi",6880,18507,293,976,26656
"5363",2012,"Missouri",19943,27029,827,2302,50101
"5364",2012,"Montana",3127,5926,91,494,9638
"5365",2012,"Nebraska",128,5162,29,12,5331
"5366",2012,"Nevada",5795,5961,268,972,12996
"5367",2012,"New Hampshire",4740,4934,45,6,9725
"5368",2012,"New Jersey",3647,5013,250,0,8910
"5369",2012,"New Mexico",5038,6492,237,654,12421
"5370",2012,"New York",6692,28126,696,328,35842
"5371",2012,"North Carolina",798,27342,530,436,29106
"5372",2012,"North Dakota",1704,4810,60,224,6798
"5373",2012,"Ohio",32230,36389,1108,3452,73179
"5374",2012,"Oklahoma",16850,20102,822,2268,40042
"5375",2012,"Oregon",12059,15041,0,0,27100
"5376",2012,"Pennsylvania",50,78231,322,0,78603
"5377",2012,"Puerto Rico",1063,172,14,44,1293
"5378",2012,"Rhode Island",1028,1224,24,404,2680
"5379",2012,"South Carolina",10098,12015,289,906,23308
"5380",2012,"South Dakota",2663,6767,74,382,9886
"5381",2012,"Tennessee",22221,28279,0,2316,52816
"5382",2012,"Texas",52840,64903,2231,6512,126486
"5383",2012,"Utah",4720,7559,121,440,12840
"5384",2012,"Vermont",1096,1994,36,130,3256
"5385",2012,"Virgin Islands",15,7,1,4,27
"5386",2012,"Virginia",22826,28382,1208,0,52416
"5387",2012,"Washington",17319,18004,1106,1250,37679
"5388",2012,"West Virginia",6753,14321,197,994,22265
"5389",2012,"Wisconsin",14976,20715,474,66,36231
"5390",2012,"Wyoming",2360,3136,85,318,5899
"5391",2012,"Alabama",12104,14698,370,1396,28568
"5392",2012,"Alaska",3453,4010,207,494,8164
"5393",2012,"Arizona",9272,7918,423,970,18583
"5394",2012,"Arkansas",4520,9560,111,726,14917
"5395",2012,"California",28860,30305,54,0,59219
"5396",2012,"Colorado",14356,15055,419,1894,31724
"5397",2012,"Connecticut",4725,4865,158,0,9748
"5398",2012,"Delaware",1171,1235,41,88,2535
"5399",2012,"District of Columbia",50,3,0,0,53
"5400",2012,"Florida",35686,23640,1071,3268,63665
"5401",2012,"Georgia",9597,12258,191,1190,23236
"5402",2012,"Guam",34,42,4,2,82
"5403",2012,"Hawaii",0,0,0,0,0
"5404",2012,"Idaho",2226,5153,71,322,7772
"5405",2012,"Illinois",13118,15029,0,1436,29583
"5406",2012,"Indiana",14083,15844,690,1154,31771
"5407",2012,"Iowa",128,4538,33,20,4719
"5408",2012,"Kansas",5721,7612,209,690,14232
"5409",2012,"Kentucky",8226,11474,154,1188,21042
"5410",2012,"Louisiana",9056,16181,352,1016,26605
"5411",2012,"Maine",2684,6431,72,340,9527
"5412",2012,"Mariana Islands",0,1,0,0,1
"5413",2012,"Maryland",5491,5835,29,28,11383
"5414",2012,"Massachusetts",4609,3111,256,318,8294
"5415",2012,"Michigan",1313,15585,243,64,17205
"5416",2012,"Minnesota",7752,20598,315,724,29389
"5417",2012,"Mississippi",4859,10027,164,658,15708
"5418",2012,"Missouri",15628,20116,634,1730,38108
"5419",2012,"Montana",2662,6824,58,470,10014
"5420",2012,"Nebraska",88,3579,15,0,3682
"5421",2012,"Nevada",4404,3703,178,732,9017
"5422",2012,"New Hampshire",3740,4058,37,6,7841
"5423",2012,"New Jersey",3393,3228,170,0,6791
"5424",2012,"New Mexico",4238,4644,160,458,9500
"5425",2012,"New York",6546,21226,540,286,28598
"5426",2012,"North Carolina",788,16214,353,420,17775
"5427",2012,"North Dakota",1559,6165,40,208,7972
"5428",2012,"Ohio",23729,21397,816,2242,48184
"5429",2012,"Oklahoma",10986,12235,475,1872,25568
"5430",2012,"Oregon",9513,10440,0,0,19953
"5431",2012,"Pennsylvania",29,58116,201,0,58346
"5432",2012,"Puerto Rico",1126,176,3,44,1349
"5433",2012,"Rhode Island",879,853,20,290,2042
"5434",2012,"South Carolina",7498,7606,223,770,16097
"5435",2012,"South Dakota",2144,7113,47,324,9628
"5436",2012,"Tennessee",16835,16902,0,1656,35393
"5437",2012,"Texas",37556,44643,1584,4702,88485
"5438",2012,"Utah",2418,4257,56,350,7081
"5439",2012,"Vermont",1061,2033,18,80,3192
"5440",2012,"Virgin Islands",26,8,1,4,39
"5441",2012,"Virginia",16759,17809,774,0,35342
"5442",2012,"Washington",13645,13258,747,1030,28680
"5443",2012,"West Virginia",5692,9496,148,896,16232
"5444",2012,"Wisconsin",12674,18015,354,42,31085
"5445",2012,"Wyoming",1550,2439,49,182,4220
"5446",2012,"Alabama",10831,12511,318,1154,24814
"5447",2012,"Alaska",2338,3131,94,300,5863
"5448",2012,"Arizona",9685,7771,364,978,18798
"5449",2012,"Arkansas",4717,7672,108,718,13215
"5450",2012,"California",26752,29344,52,0,56148
"5451",2012,"Colorado",13865,13590,370,1646,29471
"5452",2012,"Connecticut",4440,4025,170,0,8635
"5453",2012,"Delaware",1097,973,33,78,2181
"5454",2012,"District of Columbia",28,1,0,2,31
"5455",2012,"Florida",33996,20479,895,2990,58360
"5456",2012,"Georgia",9188,9206,197,902,19493
"5457",2012,"Guam",30,33,3,10,76
"5458",2012,"Hawaii",0,0,0,0,0
"5459",2012,"Idaho",2439,4728,77,338,7582
"5460",2012,"Illinois",11788,12727,0,1542,26057
"5461",2012,"Indiana",12916,12873,509,1026,27324
"5462",2012,"Iowa",81,3379,18,8,3486
"5463",2012,"Kansas",5147,6172,201,612,12132
"5464",2012,"Kentucky",7850,9397,155,1168,18570
"5465",2012,"Louisiana",11017,16304,359,1338,29018
"5466",2012,"Maine",2838,5155,96,352,8441
"5467",2012,"Mariana Islands",0,0,0,0,0
"5468",2012,"Maryland",4569,4704,25,20,9318
"5469",2012,"Massachusetts",4108,2536,198,276,7118
"5470",2012,"Michigan",1039,14424,194,50,15707
"5471",2012,"Minnesota",7119,16723,277,628,24747
"5472",2012,"Mississippi",4532,7018,146,634,12330
"5473",2012,"Missouri",15282,15154,498,1552,32486
"5474",2012,"Montana",2673,5512,71,508,8764
"5475",2012,"Nebraska",80,2506,9,6,2601
"5476",2012,"Nevada",4325,3638,192,592,8747
"5477",2012,"New Hampshire",3837,3776,31,2,7646
"5478",2012,"New Jersey",3487,2801,183,0,6471
"5479",2012,"New Mexico",4034,4265,161,426,8886
"5480",2012,"New York",5784,19289,564,228,25865
"5481",2012,"North Carolina",662,13039,261,346,14308
"5482",2012,"North Dakota",1435,4176,35,178,5824
"5483",2012,"Ohio",22700,18049,649,2376,43774
"5484",2012,"Oklahoma",10048,10635,430,1600,22713
"5485",2012,"Oregon",9240,10918,0,0,20158
"5486",2012,"Pennsylvania",27,53559,203,0,53789
"5487",2012,"Puerto Rico",931,186,9,46,1172
"5488",2012,"Rhode Island",821,791,20,278,1910
"5489",2012,"South Carolina",6784,6071,190,484,13529
"5490",2012,"South Dakota",2033,4472,49,232,6786
"5491",2012,"Tennessee",15153,14344,0,1444,30941
"5492",2012,"Texas",36471,45464,1454,4230,87619
"5493",2012,"Utah",2559,3815,47,350,6771
"5494",2012,"Vermont",1128,1774,25,112,3039
"5495",2012,"Virgin Islands",34,6,1,0,41
"5496",2012,"Virginia",17365,15658,726,0,33749
"5497",2012,"Washington",12209,11217,526,984,24936
"5498",2012,"West Virginia",5746,8041,135,746,14668
"5499",2012,"Wisconsin",11137,14610,303,48,26098
"5500",2012,"Wyoming",1599,2408,35,180,4222
"5501",2012,"Alabama",13805,12264,386,1500,27955
"5502",2012,"Alaska",2881,3703,115,400,7099
"5503",2012,"Arizona",10858,8157,420,988,20423
"5504",2012,"Arkansas",4935,6330,92,658,12015
"5505",2012,"California",29494,31911,63,0,61468
"5506",2012,"Colorado",15970,13345,430,1790,31535
"5507",2012,"Connecticut",4776,3816,171,0,8763
"5508",2012,"Delaware",1198,980,33,84,2295
"5509",2012,"District of Columbia",37,3,0,0,40
"5510",2012,"Florida",37184,20301,1162,3116,61763
"5511",2012,"Georgia",10610,9326,189,952,21077
"5512",2012,"Guam",39,36,1,4,80
"5513",2012,"Hawaii",0,0,0,0,0
"5514",2012,"Idaho",2571,4123,71,352,7117
"5515",2012,"Illinois",12980,14054,0,1310,28344
"5516",2012,"Indiana",13991,12638,593,1018,28240
"5517",2012,"Iowa",82,2810,14,6,2912
"5518",2012,"Kansas",5923,6423,241,764,13351
"5519",2012,"Kentucky",8244,8463,170,1370,18247
"5520",2012,"Louisiana",9985,11956,346,1110,23397
"5521",2012,"Maine",2833,3623,83,306,6845
"5522",2012,"Mariana Islands",0,0,0,0,0
"5523",2012,"Maryland",5534,4683,44,40,10301
"5524",2012,"Massachusetts",4616,2689,177,384,7866
"5525",2012,"Michigan",1179,11769,210,64,13222
"5526",2012,"Minnesota",7738,12588,253,658,21237
"5527",2012,"Mississippi",5764,7545,158,732,14199
"5528",2012,"Missouri",16799,15229,546,1638,34212
"5529",2012,"Montana",3047,4567,57,556,8227
"5530",2012,"Nebraska",91,2335,10,8,2444
"5531",2012,"Nevada",4693,3576,174,648,9091
"5532",2012,"New Hampshire",3890,3151,27,2,7070
"5533",2012,"New Jersey",3918,3039,222,0,7179
"5534",2012,"New Mexico",4661,4097,187,562,9507
"5535",2012,"New York",6177,14572,462,242,21453
"5536",2012,"North Carolina",663,13545,346,432,14986
"5537",2012,"North Dakota",1532,3269,32,158,4991
"5538",2012,"Ohio",23175,16601,763,2018,42557
"5539",2012,"Oklahoma",12054,10903,502,1700,25159
"5540",2012,"Oregon",9485,8795,0,0,18280
"5541",2012,"Pennsylvania",44,72106,10,0,72160
"5542",2012,"Puerto Rico",1053,285,3,66,1407
"5543",2012,"Rhode Island",771,744,13,260,1788
"5544",2012,"South Carolina",7592,6331,155,562,14640
"5545",2012,"South Dakota",2131,3794,59,278,6262
"5546",2012,"Tennessee",17328,15654,0,1506,34488
"5547",2012,"Texas",40131,44238,1693,4470,90532
"5548",2012,"Utah",2746,3221,46,316,6329
"5549",2012,"Vermont",1073,1258,21,90,2442
"5550",2012,"Virgin Islands",31,7,0,0,38
"5551",2012,"Virginia",17146,14148,745,0,32039
"5552",2012,"Washington",13652,10437,661,948,25698
"5553",2012,"West Virginia",6099,6846,152,820,13917
"5554",2012,"Wisconsin",11551,11991,311,26,23879
"5555",2012,"Wyoming",1813,2131,43,208,4195
"5556",2012,"Alabama",12182,9921,296,1134,23533
"5557",2012,"Alaska",2555,2737,84,296,5672
"5558",2012,"Arizona",9696,6340,342,860,17238
"5559",2012,"Arkansas",4346,4738,87,530,9701
"5560",2012,"California",26313,27530,52,0,53895
"5561",2012,"Colorado",13433,10672,315,1504,25924
"5562",2012,"Connecticut",4099,2942,120,0,7161
"5563",2012,"Delaware",1031,802,37,70,1940
"5564",2012,"District of Columbia",41,0,0,0,41
"5565",2012,"Florida",34543,17864,926,2654,55987
"5566",2012,"Georgia",9216,6776,173,916,17081
"5567",2012,"Guam",32,27,1,4,64
"5568",2012,"Hawaii",0,0,0,0,0
"5569",2012,"Idaho",2052,2972,58,328,5410
"5570",2012,"Illinois",11401,9755,0,1184,22340
"5571",2012,"Indiana",11809,9380,387,880,22456
"5572",2012,"Iowa",73,2036,16,4,2129
"5573",2012,"Kansas",5192,4622,178,612,10604
"5574",2012,"Kentucky",7523,6566,128,1000,15217
"5575",2012,"Louisiana",8963,8184,261,786,18194
"5576",2012,"Maine",2231,2681,71,210,5193
"5577",2012,"Mariana Islands",0,0,0,0,0
"5578",2012,"Maryland",4558,3668,38,18,8282
"5579",2012,"Massachusetts",3734,1973,132,296,6135
"5580",2012,"Michigan",1026,8053,141,46,9266
"5581",2012,"Minnesota",6424,7588,230,374,14616
"5582",2012,"Mississippi",4557,4712,113,520,9902
"5583",2012,"Missouri",13903,10796,431,1246,26376
"5584",2012,"Montana",2532,3400,46,388,6366
"5585",2012,"Nebraska",73,1595,12,4,1684
"5586",2012,"Nevada",4086,3108,148,560,7902
"5587",2012,"New Hampshire",3350,2598,20,0,5968
"5588",2012,"New Jersey",3759,2504,167,0,6430
"5589",2012,"New Mexico",3853,3378,123,422,7776
"5590",2012,"New York",6002,11448,372,172,17994
"5591",2012,"North Carolina",653,9311,234,358,10556
"5592",2012,"North Dakota",1273,2344,24,102,3743
"5593",2012,"Ohio",20677,13904,581,1678,36840
"5594",2012,"Oklahoma",10487,7960,378,1230,20055
"5595",2012,"Oregon",8707,7660,0,0,16367
"5596",2012,"Pennsylvania",40,63868,0,0,63908
"5597",2012,"Puerto Rico",962,208,3,58,1231
"5598",2012,"Rhode Island",763,622,17,168,1570
"5599",2012,"South Carolina",6315,4318,138,436,11207
"5600",2012,"South Dakota",1693,2627,34,210,4564
"5601",2012,"Tennessee",15308,11123,0,1346,27777
"5602",2012,"Texas",35783,29918,1315,3676,70692
"5603",2012,"Utah",2227,2623,35,210,5095
"5604",2012,"Vermont",985,1019,31,64,2099
"5605",2012,"Virgin Islands",25,8,0,2,35
"5606",2012,"Virginia",17361,12028,675,0,30064
"5607",2012,"Washington",12532,9007,584,836,22959
"5608",2012,"West Virginia",4976,4724,117,612,10429
"5609",2012,"Wisconsin",10575,7702,217,28,18522
"5610",2012,"Wyoming",1413,1653,36,156,3258
"5611",2012,"Alabama",11540,9390,256,1116,22302
"5612",2012,"Alaska",2783,2756,90,358,5987
"5613",2012,"Arizona",8893,6121,331,856,16201
"5614",2012,"Arkansas",4158,4241,63,586,9048
"5615",2012,"California",26514,27427,87,0,54028
"5616",2012,"Colorado",11986,10435,290,1326,24037
"5617",2012,"Connecticut",4452,3178,135,0,7765
"5618",2012,"Delaware",925,748,21,78,1772
"5619",2012,"District of Columbia",18,2,0,0,20
"5620",2012,"Florida",33679,17828,725,2604,54836
"5621",2012,"Georgia",9085,6591,154,840,16670
"5622",2012,"Guam",43,33,5,4,85
"5623",2012,"Hawaii",0,0,0,0,0
"5624",2012,"Idaho",2280,3426,53,232,5991
"5625",2012,"Illinois",11820,10114,0,1168,23102
"5626",2012,"Indiana",12193,9656,432,742,23023
"5627",2012,"Iowa",72,2177,17,2,2268
"5628",2012,"Kansas",4655,4532,134,554,9875
"5629",2012,"Kentucky",7304,6699,122,896,15021
"5630",2012,"Louisiana",8801,7345,266,736,17148
"5631",2012,"Maine",2420,2710,63,224,5417
"5632",2012,"Mariana Islands",0,1,0,0,1
"5633",2012,"Maryland",4118,3729,37,30,7914
"5634",2012,"Massachusetts",3896,2244,125,230,6495
"5635",2012,"Michigan",1083,7942,173,52,9250
"5636",2012,"Minnesota",6576,7472,197,434,14679
"5637",2012,"Mississippi",4542,4153,96,410,9201
"5638",2012,"Missouri",14002,10593,390,1274,26259
"5639",2012,"Montana",2878,3956,64,442,7340
"5640",2012,"Nebraska",70,1749,10,10,1839
"5641",2012,"Nevada",4141,3310,161,526,8138
"5642",2012,"New Hampshire",3132,2691,17,0,5840
"5643",2012,"New Jersey",4070,2484,169,0,6723
"5644",2012,"New Mexico",4166,3562,121,618,8467
"5645",2012,"New York",5894,11424,376,200,17894
"5646",2012,"North Carolina",650,9506,224,358,10738
"5647",2012,"North Dakota",1328,2498,26,116,3968
"5648",2012,"Ohio",20125,14019,462,1660,36266
"5649",2012,"Oklahoma",10167,7651,338,1346,19502
"5650",2012,"Oregon",9096,8210,0,0,17306
"5651",2012,"Pennsylvania",53,60185,0,0,60238
"5652",2012,"Puerto Rico",1027,205,6,34,1272
"5653",2012,"Rhode Island",740,601,8,216,1565
"5654",2012,"South Carolina",6625,4286,140,476,11527
"5655",2012,"South Dakota",1599,2530,28,186,4343
"5656",2012,"Tennessee",14810,10732,0,1262,26804
"5657",2012,"Texas",34768,28889,1311,3454,68422
"5658",2012,"Utah",2411,2967,42,234,5654
"5659",2012,"Vermont",1005,975,19,74,2073
"5660",2012,"Virgin Islands",30,8,0,0,38
"5661",2012,"Virginia",14451,10979,532,0,25962
"5662",2012,"Washington",13288,10506,579,868,25241
"5663",2012,"West Virginia",4691,4743,101,670,10205
"5664",2012,"Wisconsin",9771,7465,199,28,17463
"5665",2012,"Wyoming",1612,1739,37,176,3564
"5666",2012,"Alabama",11097,8917,256,986,21256
"5667",2012,"Alaska",2938,3077,95,386,6496
"5668",2012,"Arizona",9374,6136,374,788,16672
"5669",2012,"Arkansas",4128,4107,97,478,8810
"5670",2012,"California",27699,27093,72,0,54864
"5671",2012,"Colorado",12175,10380,368,1302,24225
"5672",2012,"Connecticut",4529,3187,144,0,7860
"5673",2012,"Delaware",1020,733,14,88,1855
"5674",2012,"District of Columbia",26,0,0,0,26
"5675",2012,"Florida",33310,17547,800,2474,54131
"5676",2012,"Georgia",8851,6254,145,730,15980
"5677",2012,"Guam",21,26,0,8,55
"5678",2012,"Hawaii",0,0,0,0,0
"5679",2012,"Idaho",2322,3293,59,272,5946
"5680",2012,"Illinois",11987,9817,0,1122,22926
"5681",2012,"Indiana",11816,9152,380,864,22212
"5682",2012,"Iowa",72,1916,21,6,2015
"5683",2012,"Kansas",4819,4442,151,542,9954
"5684",2012,"Kentucky",6851,6038,119,904,13912
"5685",2012,"Louisiana",7898,6675,238,644,15455
"5686",2012,"Maine",2574,2766,86,270,5696
"5687",2012,"Mariana Islands",0,1,0,0,1
"5688",2012,"Maryland",5249,3609,21,28,8907
"5689",2012,"Massachusetts",4023,2152,190,258,6623
"5690",2012,"Michigan",1137,8249,157,56,9599
"5691",2012,"Minnesota",7335,7792,215,576,15918
"5692",2012,"Mississippi",4740,3882,97,478,9197
"5693",2012,"Missouri",13959,10395,361,1248,25963
"5694",2012,"Montana",2763,3990,53,356,7162
"5695",2012,"Nebraska",85,1610,12,10,1717
"5696",2012,"Nevada",4576,3268,174,596,8614
"5697",2012,"New Hampshire",3518,2797,24,2,6341
"5698",2012,"New Jersey",4263,2498,191,0,6952
"5699",2012,"New Mexico",4058,3474,144,360,8036
"5700",2012,"New York",6541,12175,411,224,19351
"5701",2012,"North Carolina",625,9359,266,344,10594
"5702",2012,"North Dakota",1512,2547,29,112,4200
"5703",2012,"Ohio",20446,13211,551,1620,35828
"5704",2012,"Oklahoma",10357,7173,380,1274,19184
"5705",2012,"Oregon",8652,8245,0,0,16897
"5706",2012,"Pennsylvania",36,62046,0,0,62082
"5707",2012,"Puerto Rico",1068,198,3,56,1325
"5708",2012,"Rhode Island",841,680,15,238,1774
"5709",2012,"South Carolina",7126,3983,114,430,11653
"5710",2012,"South Dakota",1819,2508,41,226,4594
"5711",2012,"Tennessee",14337,9980,0,1110,25427
"5712",2012,"Texas",34541,28197,1320,3414,67472
"5713",2012,"Utah",2430,2967,61,276,5734
"5714",2012,"Vermont",995,1122,19,80,2216
"5715",2012,"Virgin Islands",41,3,0,2,46
"5716",2012,"Virginia",14213,10795,551,0,25559
"5717",2012,"Washington",13651,9650,492,822,24615
"5718",2012,"West Virginia",5025,4748,105,684,10562
"5719",2012,"Wisconsin",10997,8077,223,26,19323
"5720",2012,"Wyoming",1780,1830,31,164,3805
"5721",2012,"Alabama",11518,9586,236,1072,22412
"5722",2012,"Alaska",3274,3427,122,354,7177
"5723",2012,"Arizona",10656,6984,371,860,18871
"5724",2012,"Arkansas",4299,4209,86,502,9096
"5725",2012,"California",29500,30211,59,0,59770
"5726",2012,"Colorado",12909,11210,300,1426,25845
"5727",2012,"Connecticut",4895,3659,144,0,8698
"5728",2012,"Delaware",1096,839,21,78,2034
"5729",2012,"District of Columbia",27,1,0,2,30
"5730",2012,"Florida",34847,18257,703,2672,56479
"5731",2012,"Georgia",9481,6670,137,802,17090
"5732",2012,"Guam",26,38,3,6,73
"5733",2012,"Hawaii",0,0,0,0,0
"5734",2012,"Idaho",2509,3720,81,240,6550
"5735",2012,"Illinois",14524,11497,0,1370,27391
"5736",2012,"Indiana",13520,10411,405,946,25282
"5737",2012,"Iowa",116,2712,23,16,2867
"5738",2012,"Kansas",5453,4948,168,618,11187
"5739",2012,"Kentucky",7521,7238,125,916,15800
"5740",2012,"Louisiana",8397,6858,259,660,16174
"5741",2012,"Maine",3191,3070,86,280,6627
"5742",2012,"Mariana Islands",0,2,0,0,2
"5743",2012,"Maryland",5555,4361,43,28,9987
"5744",2012,"Massachusetts",4231,2670,235,268,7404
"5745",2012,"Michigan",1314,10018,177,52,11561
"5746",2012,"Minnesota",9004,10769,253,664,20690
"5747",2012,"Mississippi",4656,4067,96,420,9239
"5748",2012,"Missouri",15210,12050,394,1360,29014
"5749",2012,"Montana",3097,4180,51,376,7704
"5750",2012,"Nebraska",72,1934,10,4,2020
"5751",2012,"Nevada",4683,3846,176,684,9389
"5752",2012,"New Hampshire",4066,3128,32,0,7226
"5753",2012,"New Jersey",4047,2685,172,0,6904
"5754",2012,"New Mexico",4246,3779,146,348,8519
"5755",2012,"New York",6768,15285,519,264,22836
"5756",2012,"North Carolina",595,10061,248,276,11180
"5757",2012,"North Dakota",1956,3032,29,138,5155
"5758",2012,"Ohio",25352,15717,610,2076,43755
"5759",2012,"Oklahoma",10982,8339,440,1356,21117
"5760",2012,"Oregon",10426,9978,0,0,20404
"5761",2012,"Pennsylvania",29,71424,1,0,71454
"5762",2012,"Puerto Rico",980,152,8,54,1194
"5763",2012,"Rhode Island",953,720,17,232,1922
"5764",2012,"South Carolina",7911,4404,159,460,12934
"5765",2012,"South Dakota",2122,2937,42,334,5435
"5766",2012,"Tennessee",15736,10927,0,1234,27897
"5767",2012,"Texas",36296,28840,1282,3504,69922
"5768",2012,"Utah",2968,3317,82,282,6649
"5769",2012,"Vermont",1321,1468,27,92,2908
"5770",2012,"Virgin Islands",25,1,0,2,28
"5771",2012,"Virginia",17649,12196,594,0,30439
"5772",2012,"Washington",14790,11022,617,920,27349
"5773",2012,"West Virginia",5629,5942,107,690,12368
"5774",2012,"Wisconsin",14046,11444,260,24,25774
"5775",2012,"Wyoming",1786,1974,39,190,3989
"5776",2012,"Alabama",15995,12285,358,1578,30216
"5777",2012,"Alaska",3047,3112,145,362,6666
"5778",2012,"Arizona",13484,9115,466,1184,24249
"5779",2012,"Arkansas",6928,6170,107,706,13911
"5780",2012,"California",36137,38797,74,0,75008
"5781",2012,"Colorado",16271,14039,362,1904,32576
"5782",2012,"Connecticut",6139,4498,163,0,10800
"5783",2012,"Delaware",1350,1057,34,82,2523
"5784",2012,"District of Columbia",34,0,0,0,34
"5785",2012,"Florida",41823,21504,836,3028,67191
"5786",2012,"Georgia",14631,9607,277,1202,25717
"5787",2012,"Guam",30,36,3,6,75
"5788",2012,"Hawaii",0,0,0,0,0
"5789",2012,"Idaho",3474,5160,118,334,9086
"5790",2012,"Illinois",17725,14376,0,1550,33651
"5791",2012,"Indiana",18763,13250,672,1110,33795
"5792",2012,"Iowa",162,3926,25,10,4123
"5793",2012,"Kansas",8582,7394,248,662,16886
"5794",2012,"Kentucky",11306,9638,162,1222,22328
"5795",2012,"Louisiana",11125,8996,347,918,21386
"5796",2012,"Maine",4007,3768,103,404,8282
"5797",2012,"Mariana Islands",0,0,0,0,0
"5798",2012,"Maryland",6244,5099,46,34,11423
"5799",2012,"Massachusetts",5410,3128,163,298,8999
"5800",2012,"Michigan",1575,12952,186,78,14791
"5801",2012,"Minnesota",10954,12722,305,718,24699
"5802",2012,"Mississippi",6661,5848,139,556,13204
"5803",2012,"Missouri",20609,15430,617,1582,38238
"5804",2012,"Montana",3784,4832,65,454,9135
"5805",2012,"Nebraska",124,2542,8,6,2680
"5806",2012,"Nevada",5913,4642,211,760,11526
"5807",2012,"New Hampshire",4593,3402,24,2,8021
"5808",2012,"New Jersey",4266,3154,166,0,7586
"5809",2012,"New Mexico",5722,5160,249,558,11689
"5810",2012,"New York",8068,17056,552,256,25932
"5811",2012,"North Carolina",746,12962,429,338,14475
"5812",2012,"North Dakota",2657,3621,49,196,6523
"5813",2012,"Ohio",33749,19245,886,2292,56172
"5814",2012,"Oklahoma",14529,10953,565,1572,27619
"5815",2012,"Oregon",12906,12430,0,0,25336
"5816",2012,"Pennsylvania",64,92661,0,0,92725
"5817",2012,"Puerto Rico",1249,187,4,54,1494
"5818",2012,"Rhode Island",1167,934,16,240,2357
"5819",2012,"South Carolina",11548,6054,211,596,18409
"5820",2012,"South Dakota",2847,3863,59,298,7067
"5821",2012,"Tennessee",19732,14661,0,1514,35907
"5822",2012,"Texas",47874,37409,1596,4432,91311
"5823",2012,"Utah",4131,4265,72,342,8810
"5824",2012,"Vermont",1679,1776,32,156,3643
"5825",2012,"Virgin Islands",15,1,0,2,18
"5826",2012,"Virginia",21304,14545,753,0,36602
"5827",2012,"Washington",17010,12812,822,1156,31800
"5828",2012,"West Virginia",7815,7501,142,836,16294
"5829",2012,"Wisconsin",17351,14968,331,40,32690
"5830",2012,"Wyoming",2352,2485,36,222,5095
"5831",2012,"Alabama",18348,13565,312,1976,34201
"5832",2012,"Alaska",2622,2353,118,358,5451
"5833",2012,"Arizona",14082,8959,387,1356,24784
"5834",2012,"Arkansas",8513,7724,114,1238,17589
"5835",2012,"California",30902,31877,72,0,62851
"5836",2012,"Colorado",17069,14133,358,2188,33748
"5837",2012,"Connecticut",5957,4073,133,0,10163
"5838",2012,"Delaware",1463,950,28,110,2551
"5839",2012,"District of Columbia",36,2,0,2,40
"5840",2012,"Florida",43744,22852,747,3634,70977
"5841",2012,"Georgia",18514,11296,216,1816,31842
"5842",2012,"Guam",43,41,5,4,93
"5843",2012,"Hawaii",0,0,0,0,0
"5844",2012,"Idaho",3273,4340,78,500,8191
"5845",2012,"Illinois",17750,14271,0,1792,33813
"5846",2012,"Indiana",19808,14257,568,1428,36061
"5847",2012,"Iowa",153,3884,23,20,4080
"5848",2012,"Kansas",8293,7353,237,1128,17011
"5849",2012,"Kentucky",14498,11882,202,2272,28854
"5850",2012,"Louisiana",12534,9441,248,1160,23383
"5851",2012,"Maine",3446,3473,94,340,7353
"5852",2012,"Mariana Islands",0,0,0,0,0
"5853",2012,"Maryland",6192,5519,58,38,11807
"5854",2012,"Massachusetts",4431,2478,176,284,7369
"5855",2012,"Michigan",1492,12631,239,120,14482
"5856",2012,"Minnesota",9320,9761,270,648,19999
"5857",2012,"Mississippi",8447,7201,135,936,16719
"5858",2012,"Missouri",23012,16630,597,2278,42517
"5859",2012,"Montana",3705,4128,73,644,8550
"5860",2012,"Nebraska",96,2418,23,14,2551
"5861",2012,"Nevada",5623,3881,210,810,10524
"5862",2012,"New Hampshire",4297,3128,43,12,7480
"5863",2012,"New Jersey",3556,2862,127,0,6545
"5864",2012,"New Mexico",5702,4863,159,742,11466
"5865",2012,"New York",8269,17120,561,244,26194
"5866",2012,"North Carolina",857,16115,482,838,18292
"5867",2012,"North Dakota",2569,3031,53,196,5849
"5868",2012,"Ohio",35526,19840,770,3152,59288
"5869",2012,"Oklahoma",15562,11793,443,2256,30054
"5870",2012,"Oregon",12089,11200,0,0,23289
"5871",2012,"Pennsylvania",67,89116,1,0,89184
"5872",2012,"Puerto Rico",1123,178,7,38,1346
"5873",2012,"Rhode Island",1142,793,14,230,2179
"5874",2012,"South Carolina",15798,7433,287,896,24414
"5875",2012,"South Dakota",2818,3739,56,312,6925
"5876",2012,"Tennessee",25658,17153,0,2206,45017
"5877",2012,"Texas",54703,40563,1424,6350,103040
"5878",2012,"Utah",3561,3811,49,404,7825
"5879",2012,"Vermont",1602,1501,28,102,3233
"5880",2012,"Virgin Islands",33,4,0,2,39
"5881",2012,"Virginia",24439,15704,833,0,40976
"5882",2012,"Washington",16266,11830,708,1326,30130
"5883",2012,"West Virginia",8774,8171,161,1348,18454
"5884",2012,"Wisconsin",18262,11969,321,54,30606
"5885",2012,"Wyoming",2094,2124,47,290,4555
"5886",2012,"Alabama",11998,11176,265,1002,24441
"5887",2012,"Alaska",1645,1713,58,204,3620
"5888",2012,"Arizona",9570,6969,321,842,17702
"5889",2012,"Arkansas",4886,5554,80,636,11156
"5890",2012,"California",25812,25757,59,0,51628
"5891",2012,"Colorado",13711,11801,274,3860,29646
"5892",2012,"Connecticut",4894,3904,147,0,8945
"5893",2012,"Delaware",1168,820,23,80,2091
"5894",2012,"District of Columbia",43,2,0,0,45
"5895",2012,"Florida",34951,18761,587,2804,57103
"5896",2012,"Georgia",10796,8258,176,914,20144
"5897",2012,"Guam",29,42,3,8,82
"5898",2012,"Hawaii",2,2,2,4,10
"5899",2012,"Idaho",2368,3491,56,308,6223
"5900",2012,"Illinois",13424,11581,0,1214,26219
"5901",2012,"Indiana",14224,10574,511,936,26245
"5902",2012,"Iowa",142,3006,16,8,3172
"5903",2012,"Kansas",6316,6557,205,628,13706
"5904",2012,"Kentucky",8633,7855,154,1062,17704
"5905",2012,"Louisiana",8549,9237,215,728,18729
"5906",2012,"Maine",2438,2777,91,224,5530
"5907",2012,"Mariana Islands",0,0,0,0,0
"5908",2012,"Maryland",4431,4196,28,26,8681
"5909",2012,"Massachusetts",4008,2157,128,266,6559
"5910",2012,"Michigan",1224,8653,166,78,10121
"5911",2012,"Minnesota",7238,7956,196,532,15922
"5912",2012,"Mississippi",4703,6212,98,514,11527
"5913",2012,"Missouri",15948,12991,442,1576,30957
"5914",2012,"Montana",2684,3218,50,372,6324
"5915",2012,"Nebraska",75,2613,17,8,2713
"5916",2012,"Nevada",4416,3282,165,552,8415
"5917",2012,"New Hampshire",3406,2573,22,2,6003
"5918",2012,"New Jersey",2920,2293,99,0,5312
"5919",2012,"New Mexico",3960,3531,140,404,8035
"5920",2012,"New York",6654,11877,402,176,19109
"5921",2012,"North Carolina",564,11920,390,328,13202
"5922",2012,"North Dakota",1862,2709,42,144,4757
"5923",2012,"Ohio",22307,13742,532,1520,38101
"5924",2012,"Oklahoma",11440,9760,372,1386,22958
"5925",2012,"Oregon",8921,8346,1,104,17372
"5926",2012,"Pennsylvania",19,66405,0,0,66424
"5927",2012,"Puerto Rico",806,108,5,34,953
"5928",2012,"Rhode Island",868,681,16,212,1777
"5929",2012,"South Carolina",8972,5218,156,564,14910
"5930",2012,"South Dakota",2000,3541,42,210,5793
"5931",2012,"Tennessee",18029,12590,0,1426,32045
"5932",2012,"Texas",38234,34319,1196,3890,77639
"5933",2012,"Utah",2681,3052,53,278,6064
"5934",2012,"Vermont",945,1048,24,68,2085
"5935",2012,"Virgin Islands",23,5,0,0,28
"5936",2012,"Virginia",15822,11720,577,0,28119
"5937",2012,"Washington",12273,8772,513,846,22404
"5938",2012,"West Virginia",5384,6047,137,662,12230
"5939",2012,"Wisconsin",12254,8655,227,44,21180
"5940",2012,"Wyoming",1513,1622,25,188,3348
"5941",2011,"Alabama",17651,28564,260,1440,47915
"5942",2011,"Alaska",2851,3715,93,284,6943
"5943",2011,"Arizona",12018,11689,366,1056,25129
"5944",2011,"Arkansas",6900,13747,83,652,21382
"5945",2011,"California",29452,36425,54,0,65931
"5946",2011,"Colorado",16990,19525,0,6036,42551
"5947",2011,"Connecticut",5210,5383,163,0,10756
"5948",2011,"Delaware",1430,1760,29,90,3309
"5949",2011,"District of Columbia",19,2,0,0,21
"5950",2011,"Florida",40463,31791,0,4268,76522
"5951",2011,"Georgia",15777,22801,190,1332,40100
"5952",2011,"Guam",38,38,1,4,81
"5953",2011,"Hawaii",0,0,0,0,0
"5954",2011,"Idaho",3584,6887,93,322,10886
"5955",2011,"Illinois",15946,18596,0,1690,36232
"5956",2011,"Indiana",16616,19842,435,1096,37989
"5957",2011,"Iowa",145,6670,12,10,6837
"5958",2011,"Kansas",7204,11848,241,818,20111
"5959",2011,"Kentucky",12400,19464,174,1376,33414
"5960",2011,"Louisiana",12503,24866,218,1170,38757
"5961",2011,"Maine",3061,5123,97,310,8591
"5962",2011,"Mariana Islands",0,0,0,0,0
"5963",2011,"Maryland",4522,7805,36,18,12381
"5964",2011,"Massachusetts",4399,2948,115,298,7760
"5965",2011,"Michigan",1394,17339,141,68,18942
"5966",2011,"Minnesota",8269,13584,230,564,22647
"5967",2011,"Mississippi",7880,19013,149,754,27796
"5968",2011,"Missouri",19205,23887,486,1602,45180
"5969",2011,"Montana",3475,6151,39,444,10109
"5970",2011,"Nebraska",135,5431,24,12,5602
"5971",2011,"Nevada",5671,5643,113,736,12163
"5972",2011,"New Hampshire",3771,3915,36,18,7740
"5973",2011,"New Jersey",2928,3883,130,0,6941
"5974",2011,"New Mexico",5083,6281,119,500,11983
"5975",2011,"New York",6497,21271,366,184,28318
"5976",2011,"North Carolina",653,27849,311,402,29215
"5977",2011,"North Dakota",1811,4256,43,154,6264
"5978",2011,"Ohio",29717,28886,594,2324,61521
"5979",2011,"Oklahoma",13809,18920,367,1794,34890
"5980",2011,"Oregon",10490,13794,0,1170,25454
"5981",2011,"Pennsylvania",32,83662,2,0,83696
"5982",2011,"Puerto Rico",1018,177,2,44,1241
"5983",2011,"Rhode Island",921,896,21,246,2084
"5984",2011,"South Carolina",11221,13522,165,696,25604
"5985",2011,"South Dakota",2346,5734,42,290,8412
"5986",2011,"Tennessee",24452,27923,0,2008,54383
"5987",2011,"Texas",55187,73202,1288,5152,134829
"5988",2011,"Utah",4498,8103,6,536,13143
"5989",2011,"Vermont",1198,1819,27,80,3124
"5990",2011,"Virgin Islands",28,6,0,4,38
"5991",2011,"Virginia",19470,23046,84,1198,43798
"5992",2011,"Washington",16005,15941,595,942,33483
"5993",2011,"West Virginia",8082,13332,137,948,22499
"5994",2011,"Wisconsin",15127,13551,261,98,29037
"5995",2011,"Wyoming",2350,3227,40,200,5817
"5996",2011,"Alabama",11548,20228,176,1170,33122
"5997",2011,"Alaska",2019,2783,75,250,5127
"5998",2011,"Arizona",8315,8157,245,824,17541
"5999",2011,"Arkansas",4022,12035,64,616,16737
"6000",2011,"California",23885,30091,49,0,54025
"6001",2011,"Colorado",12727,15131,0,7416,35274
"6002",2011,"Connecticut",3855,4084,112,0,8051
"6003",2011,"Delaware",971,1402,18,62,2453
"6004",2011,"District of Columbia",33,0,0,0,33
"6005",2011,"Florida",30827,23480,0,3400,57707
"6006",2011,"Georgia",8691,14424,103,878,24096
"6007",2011,"Guam",23,12,1,2,38
"6008",2011,"Hawaii",0,0,0,0,0
"6009",2011,"Idaho",2269,4537,67,266,7139
"6010",2011,"Illinois",12039,16397,0,1326,29762
"6011",2011,"Indiana",11350,17074,324,898,29646
"6012",2011,"Iowa",134,6094,13,12,6253
"6013",2011,"Kansas",5262,10033,165,698,16158
"6014",2011,"Kentucky",7447,15122,124,1042,23735
"6015",2011,"Louisiana",8077,17355,181,882,26495
"6016",2011,"Maine",2087,4270,65,256,6678
"6017",2011,"Mariana Islands",0,0,0,0,0
"6018",2011,"Maryland",3760,7540,28,32,11360
"6019",2011,"Massachusetts",3475,2605,80,244,6404
"6020",2011,"Michigan",1005,18342,92,44,19483
"6021",2011,"Minnesota",5749,12848,184,462,19243
"6022",2011,"Mississippi",4776,14867,114,672,20429
"6023",2011,"Missouri",12697,20547,315,1260,34819
"6024",2011,"Montana",2134,4327,54,454,6969
"6025",2011,"Nebraska",82,4494,13,6,4595
"6026",2011,"Nevada",4176,4092,0,550,8818
"6027",2011,"New Hampshire",2783,3236,30,8,6057
"6028",2011,"New Jersey",2504,3291,101,0,5896
"6029",2011,"New Mexico",3737,4418,82,372,8609
"6030",2011,"New York",5030,20098,322,154,25604
"6031",2011,"North Carolina",299,19954,210,316,20779
"6032",2011,"North Dakota",1332,3914,21,144,5411
"6033",2011,"Ohio",21362,24640,436,1862,48300
"6034",2011,"Oklahoma",9810,14561,297,1360,26028
"6035",2011,"Oregon",7772,9906,0,946,18624
"6036",2011,"Pennsylvania",24,73464,0,0,73488
"6037",2011,"Puerto Rico",927,149,3,42,1121
"6038",2011,"Rhode Island",713,712,20,178,1623
"6039",2011,"South Carolina",7743,9294,168,574,17779
"6040",2011,"South Dakota",1556,5038,47,230,6871
"6041",2011,"Tennessee",16350,21019,0,1542,38911
"6042",2011,"Texas",35928,49253,904,4218,90303
"6043",2011,"Utah",3021,5120,0,572,8713
"6044",2011,"Vermont",865,1710,11,60,2646
"6045",2011,"Virgin Islands",15,3,0,0,18
"6046",2011,"Virginia",14798,19089,0,1234,35121
"6047",2011,"Washington",11354,11057,466,812,23689
"6048",2011,"West Virginia",4556,12314,74,734,17678
"6049",2011,"Wisconsin",12245,15947,194,84,28470
"6050",2011,"Wyoming",1501,2232,31,194,3958
"6051",2011,"Alabama",9228,12879,153,986,23246
"6052",2011,"Alaska",2910,3813,96,398,7217
"6053",2011,"Arizona",7915,6449,202,758,15324
"6054",2011,"Arkansas",3654,8444,54,640,12792
"6055",2011,"California",26693,28249,44,0,54986
"6056",2011,"Colorado",11441,13612,0,5684,30737
"6057",2011,"Connecticut",3643,3650,84,0,7377
"6058",2011,"Delaware",944,1137,17,84,2182
"6059",2011,"District of Columbia",35,0,0,0,35
"6060",2011,"Florida",29491,18379,0,3386,51256
"6061",2011,"Georgia",7788,11056,146,798,19788
"6062",2011,"Guam",25,23,2,4,54
"6063",2011,"Hawaii",0,0,0,0,0
"6064",2011,"Idaho",2051,4538,49,292,6930
"6065",2011,"Illinois",10417,12084,0,1042,23543
"6066",2011,"Indiana",10498,12206,354,682,23740
"6067",2011,"Iowa",99,4192,15,6,4312
"6068",2011,"Kansas",4628,6958,166,612,12364
"6069",2011,"Kentucky",6373,10721,90,1056,18240
"6070",2011,"Louisiana",7426,13823,145,774,22168
"6071",2011,"Maine",2256,5955,49,248,8508
"6072",2011,"Mariana Islands",0,0,0,0,0
"6073",2011,"Maryland",3556,5214,19,32,8821
"6074",2011,"Massachusetts",3266,2261,90,194,5811
"6075",2011,"Michigan",1026,13687,119,54,14886
"6076",2011,"Minnesota",5784,17421,196,484,23885
"6077",2011,"Mississippi",3891,8707,110,560,13268
"6078",2011,"Missouri",12526,16426,311,1262,30525
"6079",2011,"Montana",2251,6187,31,504,8973
"6080",2011,"Nebraska",71,3318,6,12,3407
"6081",2011,"Nevada",3938,3211,0,542,7691
"6082",2011,"New Hampshire",2809,3337,50,22,6218
"6083",2011,"New Jersey",2473,2514,0,168,5155
"6084",2011,"New Mexico",3760,3971,107,354,8192
"6085",2011,"New York",5101,17748,297,186,23332
"6086",2011,"North Carolina",237,14253,224,344,15058
"6087",2011,"North Dakota",1506,5449,19,160,7134
"6088",2011,"Ohio",19153,16836,430,1716,38135
"6089",2011,"Oklahoma",7583,9610,239,1226,18658
"6090",2011,"Oregon",7028,8737,0,976,16741
"6091",2011,"Pennsylvania",26,62938,1,24,62989
"6092",2011,"Puerto Rico",947,171,1,36,1155
"6093",2011,"Rhode Island",646,693,17,216,1572
"6094",2011,"South Carolina",5432,6442,106,452,12432
"6095",2011,"South Dakota",1515,6322,27,274,8138
"6096",2011,"Tennessee",13883,14326,0,1360,29569
"6097",2011,"Texas",30160,38398,852,3466,72876
"6098",2011,"Utah",2102,4032,0,286,6420
"6099",2011,"Vermont",845,1781,18,50,2694
"6100",2011,"Virgin Islands",29,1,0,4,34
"6101",2011,"Virginia",13968,14629,0,1224,29821
"6102",2011,"Washington",10657,10328,377,778,22140
"6103",2011,"West Virginia",4643,8595,92,734,14064
"6104",2011,"Wisconsin",9103,14772,195,52,24122
"6105",2011,"Wyoming",1332,1988,18,158,3496
"6106",2011,"Alabama",9549,10728,196,1038,21511
"6107",2011,"Alaska",1965,3014,68,252,5299
"6108",2011,"Arizona",7936,6614,280,786,15616
"6109",2011,"Arkansas",4168,6849,70,700,11787
"6110",2011,"California",22197,23657,39,0,45893
"6111",2011,"Colorado",11700,12309,0,7184,31193
"6112",2011,"Connecticut",3662,3220,94,0,6976
"6113",2011,"Delaware",830,845,31,86,1792
"6114",2011,"District of Columbia",38,1,0,0,39
"6115",2011,"Florida",29341,16267,0,3334,48942
"6116",2011,"Georgia",8329,8954,124,772,18179
"6117",2011,"Guam",13,16,5,6,40
"6118",2011,"Hawaii",0,0,0,0,0
"6119",2011,"Idaho",2207,4158,43,288,6696
"6120",2011,"Illinois",9915,10724,0,1212,21851
"6121",2011,"Indiana",9423,10639,281,668,21011
"6122",2011,"Iowa",88,3390,11,8,3497
"6123",2011,"Kansas",3649,5526,115,546,9836
"6124",2011,"Kentucky",6331,8904,103,1088,16426
"6125",2011,"Louisiana",8856,15185,207,934,25182
"6126",2011,"Maine",2219,4274,49,234,6776
"6127",2011,"Mariana Islands",0,0,0,0,0
"6128",2011,"Maryland",3307,3910,19,34,7270
"6129",2011,"Massachusetts",3279,2113,85,160,5637
"6130",2011,"Michigan",945,12997,123,46,14111
"6131",2011,"Minnesota",5492,15315,179,464,21450
"6132",2011,"Mississippi",3739,7119,92,570,11520
"6133",2011,"Missouri",12359,12894,330,1256,26839
"6134",2011,"Montana",2442,5001,36,486,7965
"6135",2011,"Nebraska",81,2324,14,2,2421
"6136",2011,"Nevada",4048,3066,0,554,7668
"6137",2011,"New Hampshire",2928,2776,16,10,5730
"6138",2011,"New Jersey",2403,2200,0,174,4777
"6139",2011,"New Mexico",3428,3596,94,402,7520
"6140",2011,"New York",4894,16404,341,164,21803
"6141",2011,"North Carolina",257,11602,210,390,12459
"6142",2011,"North Dakota",1203,3905,23,114,5245
"6143",2011,"Ohio",17864,14411,450,1642,34367
"6144",2011,"Oklahoma",7612,8896,293,1474,18275
"6145",2011,"Oregon",6952,9093,0,1034,17079
"6146",2011,"Pennsylvania",0,58431,0,144,58575
"6147",2011,"Puerto Rico",857,198,3,52,1110
"6148",2011,"Rhode Island",660,580,15,190,1445
"6149",2011,"South Carolina",5551,5992,134,424,12101
"6150",2011,"South Dakota",1478,4011,30,262,5781
"6151",2011,"Tennessee",13175,12204,0,1288,26667
"6152",2011,"Texas",29410,41207,760,3578,74955
"6153",2011,"Utah",2286,3979,0,350,6615
"6154",2011,"Vermont",924,1430,18,86,2458
"6155",2011,"Virgin Islands",24,4,0,0,28
"6156",2011,"Virginia",12701,12134,0,1026,25861
"6157",2011,"Washington",9924,9314,353,854,20445
"6158",2011,"West Virginia",4378,7055,85,732,12250
"6159",2011,"Wisconsin",8176,12953,156,26,21311
"6160",2011,"Wyoming",1531,2206,20,176,3933
"6161",2011,"Alabama",9863,10576,161,960,21560
"6162",2011,"Alaska",2221,3359,59,240,5879
"6163",2011,"Arizona",7684,6476,252,772,15184
"6164",2011,"Arkansas",3651,5251,66,506,9474
"6165",2011,"California",23431,27619,0,0,51050
"6166",2011,"Colorado",11775,11469,0,4734,27978
"6167",2011,"Connecticut",3912,2964,90,0,6966
"6168",2011,"Delaware",770,713,17,84,1584
"6169",2011,"District of Columbia",11,0,0,0,11
"6170",2011,"Florida",29668,15927,0,3286,48881
"6171",2011,"Georgia",8237,7957,122,904,17220
"6172",2011,"Guam",15,20,0,0,35
"6173",2011,"Hawaii",0,0,0,0,0
"6174",2011,"Idaho",2068,3527,46,244,5885
"6175",2011,"Illinois",9947,10717,0,1028,21692
"6176",2011,"Indiana",9898,9924,338,662,20822
"6177",2011,"Iowa",69,2629,11,4,2713
"6178",2011,"Kansas",4080,5373,126,640,10219
"6179",2011,"Kentucky",6336,7407,91,1122,14956
"6180",2011,"Louisiana",7465,10194,163,868,18690
"6181",2011,"Maine",2089,3125,51,282,5547
"6182",2011,"Mariana Islands",0,0,0,0,0
"6183",2011,"Maryland",3647,3950,19,22,7638
"6184",2011,"Massachusetts",3484,2114,94,244,5936
"6185",2011,"Michigan",986,10367,89,54,11496
"6186",2011,"Minnesota",5288,10716,154,440,16598
"6187",2011,"Mississippi",4273,6099,106,512,10990
"6188",2011,"Missouri",12579,11701,284,1250,25814
"6189",2011,"Montana",2425,3871,34,414,6744
"6190",2011,"Nebraska",85,2189,10,12,2296
"6191",2011,"Nevada",4140,3276,0,564,7980
"6192",2011,"New Hampshire",2589,2260,12,16,4877
"6193",2011,"New Jersey",2426,2047,0,160,4633
"6194",2011,"New Mexico",3758,3518,103,356,7735
"6195",2011,"New York",4973,11860,237,158,17228
"6196",2011,"North Carolina",245,10475,215,348,11283
"6197",2011,"North Dakota",1346,2869,26,128,4369
"6198",2011,"Ohio",17325,13410,345,1486,32566
"6199",2011,"Oklahoma",8132,8191,291,1328,17942
"6200",2011,"Oregon",6591,7234,0,868,14693
"6201",2011,"Pennsylvania",6,54551,0,264,54821
"6202",2011,"Puerto Rico",794,173,1,46,1014
"6203",2011,"Rhode Island",686,576,7,196,1465
"6204",2011,"South Carolina",5638,5374,108,428,11548
"6205",2011,"South Dakota",1595,3239,32,230,5096
"6206",2011,"Tennessee",13887,12061,0,1294,27242
"6207",2011,"Texas",30112,35200,865,3416,69593
"6208",2011,"Utah",2198,3042,0,252,5492
"6209",2011,"Vermont",833,1087,16,74,2010
"6210",2011,"Virgin Islands",18,2,0,0,20
"6211",2011,"Virginia",12084,10470,0,1066,23620
"6212",2011,"Washington",10265,8597,422,826,20110
"6213",2011,"West Virginia",4306,5530,89,616,10541
"6214",2011,"Wisconsin",8254,10196,124,28,18602
"6215",2011,"Wyoming",1361,1840,26,170,3397
"6216",2011,"Alabama",8988,8152,161,902,18203
"6217",2011,"Alaska",2146,2457,61,264,4928
"6218",2011,"Arizona",7367,4997,244,638,13246
"6219",2011,"Arkansas",3504,3806,46,488,7844
"6220",2011,"California",21925,21196,0,0,43121
"6221",2011,"Colorado",10070,8781,0,6520,25371
"6222",2011,"Connecticut",3390,2501,76,0,5967
"6223",2011,"Delaware",737,561,18,62,1378
"6224",2011,"District of Columbia",3,0,0,0,3
"6225",2011,"Florida",27240,13412,0,2910,43562
"6226",2011,"Georgia",7543,5779,138,648,14108
"6227",2011,"Guam",17,19,0,4,40
"6228",2011,"Hawaii",0,0,0,0,0
"6229",2011,"Idaho",1798,2685,46,210,4739
"6230",2011,"Illinois",8812,7396,0,1010,17218
"6231",2011,"Indiana",8622,6938,240,670,16470
"6232",2011,"Iowa",37,1812,17,6,1872
"6233",2011,"Kansas",3629,3734,111,430,7904
"6234",2011,"Kentucky",5763,5421,74,780,12038
"6235",2011,"Louisiana",7296,6809,175,622,14902
"6236",2011,"Maine",1952,2629,36,244,4861
"6237",2011,"Mariana Islands",0,0,0,0,0
"6238",2011,"Maryland",3086,3197,23,36,6342
"6239",2011,"Massachusetts",3114,1600,87,202,5003
"6240",2011,"Michigan",1040,6613,100,44,7797
"6241",2011,"Minnesota",4214,6233,150,328,10925
"6242",2011,"Mississippi",3772,3919,78,456,8225
"6243",2011,"Missouri",11070,8276,289,924,20559
"6244",2011,"Montana",2157,3281,44,342,5824
"6245",2011,"Nebraska",56,1331,7,4,1398
"6246",2011,"Nevada",3816,2804,0,426,7046
"6247",2011,"New Hampshire",2411,1990,16,8,4425
"6248",2011,"New Jersey",2449,1754,0,160,4363
"6249",2011,"New Mexico",3167,2890,80,524,6661
"6250",2011,"New York",4069,8408,212,150,12839
"6251",2011,"North Carolina",242,7556,169,278,8245
"6252",2011,"North Dakota",947,2007,16,108,3078
"6253",2011,"Ohio",15404,10937,415,1298,28054
"6254",2011,"Oklahoma",7373,6184,245,1072,14874
"6255",2011,"Oregon",6289,6345,0,1064,13698
"6256",2011,"Pennsylvania",0,45503,0,80,45583
"6257",2011,"Puerto Rico",633,163,3,34,833
"6258",2011,"Rhode Island",570,437,11,174,1192
"6259",2011,"South Carolina",4797,3631,114,350,8892
"6260",2011,"South Dakota",1227,2133,25,146,3531
"6261",2011,"Tennessee",12455,8834,0,1036,22325
"6262",2011,"Texas",28000,24870,760,3214,56844
"6263",2011,"Utah",1956,2536,0,290,4782
"6264",2011,"Vermont",731,777,16,54,1578
"6265",2011,"Virgin Islands",18,3,0,0,21
"6266",2011,"Virginia",13419,9388,0,928,23735
"6267",2011,"Washington",9471,7452,393,754,18070
"6268",2011,"West Virginia",3890,4236,70,552,8748
"6269",2011,"Wisconsin",7359,6356,110,46,13871
"6270",2011,"Wyoming",1269,1485,20,116,2890
"6271",2011,"Alabama",9388,7951,153,846,18338
"6272",2011,"Alaska",2201,2254,66,224,4745
"6273",2011,"Arizona",7204,4908,220,658,12990
"6274",2011,"Arkansas",3496,3390,64,446,7396
"6275",2011,"California",24632,24012,0,0,48644
"6276",2011,"Colorado",10394,9130,0,5700,25224
"6277",2011,"Connecticut",3866,2510,94,0,6470
"6278",2011,"Delaware",732,597,18,68,1415
"6279",2011,"District of Columbia",6,0,0,0,6
"6280",2011,"Florida",27744,13091,0,2940,43775
"6281",2011,"Georgia",7746,5227,114,564,13651
"6282",2011,"Guam",18,19,2,2,41
"6283",2011,"Hawaii",0,0,0,0,0
"6284",2011,"Idaho",1918,3067,46,210,5241
"6285",2011,"Illinois",9059,7372,0,850,17281
"6286",2011,"Indiana",8876,6861,251,642,16630
"6287",2011,"Iowa",43,1803,8,6,1860
"6288",2011,"Kansas",3434,3369,87,392,7282
"6289",2011,"Kentucky",5729,5255,89,816,11889
"6290",2011,"Louisiana",7322,5973,147,648,14090
"6291",2011,"Maine",1945,2184,31,200,4360
"6292",2011,"Mariana Islands",0,0,0,0,0
"6293",2011,"Maryland",3277,2896,16,18,6207
"6294",2011,"Massachusetts",3143,1598,77,170,4988
"6295",2011,"Michigan",1177,6719,90,62,8048
"6296",2011,"Minnesota",4862,6241,154,418,11675
"6297",2011,"Mississippi",3541,3283,63,406,7293
"6298",2011,"Missouri",11684,7896,258,974,20812
"6299",2011,"Montana",2154,3325,42,344,5865
"6300",2011,"Nebraska",73,1357,9,4,1443
"6301",2011,"Nevada",3756,2919,0,556,7231
"6302",2011,"New Hampshire",2373,1941,10,18,4342
"6303",2011,"New Jersey",2586,1806,0,158,4550
"6304",2011,"New Mexico",3492,2877,82,342,6793
"6305",2011,"New York",4850,8697,225,146,13918
"6306",2011,"North Carolina",241,7371,158,246,8016
"6307",2011,"North Dakota",895,2010,17,90,3012
"6308",2011,"Ohio",15226,9991,370,1182,26769
"6309",2011,"Oklahoma",7401,5743,208,1008,14360
"6310",2011,"Oregon",7074,7264,0,1280,15618
"6311",2011,"Pennsylvania",1,46047,0,300,46348
"6312",2011,"Puerto Rico",807,126,5,60,998
"6313",2011,"Rhode Island",605,493,18,158,1274
"6314",2011,"South Carolina",5043,3281,148,350,8822
"6315",2011,"South Dakota",1349,2127,35,136,3647
"6316",2011,"Tennessee",12513,7998,0,1068,21579
"6317",2011,"Texas",28911,23268,766,3000,55945
"6318",2011,"Utah",2109,2798,0,280,5187
"6319",2011,"Vermont",801,872,10,56,1739
"6320",2011,"Virgin Islands",35,3,0,0,38
"6321",2011,"Virginia",10945,7884,0,900,19729
"6322",2011,"Washington",9852,7829,407,762,18850
"6323",2011,"West Virginia",3924,3799,63,588,8374
"6324",2011,"Wisconsin",6548,6686,111,28,13373
"6325",2011,"Wyoming",1379,1541,26,130,3076
"6326",2011,"Alabama",8950,7192,151,860,17153
"6327",2011,"Alaska",2370,2530,54,278,5232
"6328",2011,"Arizona",7868,5278,253,606,14005
"6329",2011,"Arkansas",3659,3438,43,510,7650
"6330",2011,"California",22849,22801,0,0,45650
"6331",2011,"Colorado",11276,9670,0,7158,28104
"6332",2011,"Connecticut",4046,2754,80,0,6880
"6333",2011,"Delaware",743,624,18,54,1439
"6334",2011,"District of Columbia",14,1,0,0,15
"6335",2011,"Florida",27882,12952,0,2612,43446
"6336",2011,"Georgia",7930,5154,113,604,13801
"6337",2011,"Guam",18,13,2,4,37
"6338",2011,"Hawaii",0,0,0,0,0
"6339",2011,"Idaho",1989,3283,46,240,5558
"6340",2011,"Illinois",9700,8132,0,964,18796
"6341",2011,"Indiana",8658,7073,241,600,16572
"6342",2011,"Iowa",46,1809,6,10,1871
"6343",2011,"Kansas",3852,3713,73,458,8096
"6344",2011,"Kentucky",5872,5437,96,776,12181
"6345",2011,"Louisiana",6884,5585,128,550,13147
"6346",2011,"Maine",1926,2376,38,218,4558
"6347",2011,"Mariana Islands",0,0,0,0,0
"6348",2011,"Maryland",3630,3093,26,18,6767
"6349",2011,"Massachusetts",3308,1533,110,168,5119
"6350",2011,"Michigan",1222,7634,104,76,9036
"6351",2011,"Minnesota",5661,6988,144,358,13151
"6352",2011,"Mississippi",3738,3252,60,386,7436
"6353",2011,"Missouri",12186,8850,254,994,22284
"6354",2011,"Montana",2340,3613,41,336,6330
"6355",2011,"Nebraska",78,1555,9,6,1648
"6356",2011,"Nevada",4375,3208,0,550,8133
"6357",2011,"New Hampshire",2341,2134,10,6,4491
"6358",2011,"New Jersey",2733,1908,0,206,4847
"6359",2011,"New Mexico",3627,2940,106,336,7009
"6360",2011,"New York",5153,9953,250,160,15516
"6361",2011,"North Carolina",222,7265,180,256,7923
"6362",2011,"North Dakota",1086,2288,17,110,3501
"6363",2011,"Ohio",17056,10842,359,1282,29539
"6364",2011,"Oklahoma",7472,5659,206,934,14271
"6365",2011,"Oregon",8047,8145,0,1248,17440
"6366",2011,"Pennsylvania",3,48124,0,120,48247
"6367",2011,"Puerto Rico",795,149,8,44,996
"6368",2011,"Rhode Island",625,471,8,174,1278
"6369",2011,"South Carolina",4951,3294,70,356,8671
"6370",2011,"South Dakota",1464,2445,37,176,4122
"6371",2011,"Tennessee",12655,7927,0,982,21564
"6372",2011,"Texas",29323,24239,767,2764,57093
"6373",2011,"Utah",2268,3094,0,280,5642
"6374",2011,"Vermont",895,887,15,72,1869
"6375",2011,"Virgin Islands",27,3,0,0,30
"6376",2011,"Virginia",11938,8266,0,910,21114
"6377",2011,"Washington",10296,8059,423,688,19466
"6378",2011,"West Virginia",4023,4109,58,464,8654
"6379",2011,"Wisconsin",6414,7485,141,18,14058
"6380",2011,"Wyoming",1435,1768,39,150,3392
"6381",2011,"Alabama",9332,8242,175,832,18581
"6382",2011,"Alaska",3008,3560,105,344,7017
"6383",2011,"Arizona",9411,6361,273,758,16803
"6384",2011,"Arkansas",4180,4296,67,574,9117
"6385",2011,"California",30345,29788,0,0,60133
"6386",2011,"Colorado",12616,11577,0,8346,32539
"6387",2011,"Connecticut",4600,3579,116,0,8295
"6388",2011,"Delaware",898,738,21,50,1707
"6389",2011,"District of Columbia",36,1,0,4,41
"6390",2011,"Florida",30697,14985,0,2798,48480
"6391",2011,"Georgia",8447,6021,132,720,15320
"6392",2011,"Guam",17,22,2,4,45
"6393",2011,"Hawaii",0,0,0,0,0
"6394",2011,"Idaho",2434,4051,60,270,6815
"6395",2011,"Illinois",11468,9467,0,1032,21967
"6396",2011,"Indiana",10938,9339,285,816,21378
"6397",2011,"Iowa",59,2984,21,2,3066
"6398",2011,"Kansas",5097,4813,165,594,10669
"6399",2011,"Kentucky",7336,7619,130,902,15987
"6400",2011,"Louisiana",7733,5914,150,612,14409
"6401",2011,"Maine",2459,2865,45,232,5601
"6402",2011,"Mariana Islands",0,0,0,0,0
"6403",2011,"Maryland",4226,4002,35,38,8301
"6404",2011,"Massachusetts",4001,2211,97,232,6541
"6405",2011,"Michigan",1640,10169,135,72,12016
"6406",2011,"Minnesota",7478,11302,215,510,19505
"6407",2011,"Mississippi",4367,3689,64,410,8530
"6408",2011,"Missouri",14435,11840,298,1090,27663
"6409",2011,"Montana",2637,4230,49,408,7324
"6410",2011,"Nebraska",144,1878,8,10,2040
"6411",2011,"Nevada",4410,3383,0,554,8347
"6412",2011,"New Hampshire",3045,2850,10,34,5939
"6413",2011,"New Jersey",2874,2363,0,178,5415
"6414",2011,"New Mexico",3988,3516,109,350,7963
"6415",2011,"New York",6408,13721,375,220,20724
"6416",2011,"North Carolina",295,8863,254,264,9676
"6417",2011,"North Dakota",1347,3022,20,96,4485
"6418",2011,"Ohio",21622,14325,472,1644,38063
"6419",2011,"Oklahoma",9396,7599,351,1114,18460
"6420",2011,"Oregon",8906,9231,0,1482,19619
"6421",2011,"Pennsylvania",2,61720,0,236,61958
"6422",2011,"Puerto Rico",647,145,6,42,840
"6423",2011,"Rhode Island",835,617,19,178,1649
"6424",2011,"South Carolina",6075,4063,87,396,10621
"6425",2011,"South Dakota",1880,3050,42,216,5188
"6426",2011,"Tennessee",13983,9779,0,1150,24912
"6427",2011,"Texas",31570,25708,898,3128,61304
"6428",2011,"Utah",3009,3589,0,366,6964
"6429",2011,"Vermont",1039,1508,18,92,2657
"6430",2011,"Virgin Islands",16,1,0,0,17
"6431",2011,"Virginia",15008,10407,0,1014,26429
"6432",2011,"Washington",11843,9640,465,856,22804
"6433",2011,"West Virginia",5067,5560,103,638,11368
"6434",2011,"Wisconsin",7165,11960,196,28,19349
"6435",2011,"Wyoming",1650,1870,46,172,3738
"6436",2011,"Alabama",12176,10579,230,1068,24053
"6437",2011,"Alaska",2654,3017,130,312,6113
"6438",2011,"Arizona",11393,7362,337,804,19896
"6439",2011,"Arkansas",6184,5909,85,626,12804
"6440",2011,"California",29994,30323,0,0,60317
"6441",2011,"Colorado",14811,13223,0,8334,36368
"6442",2011,"Connecticut",5267,4147,83,0,9497
"6443",2011,"Delaware",1215,855,26,50,2146
"6444",2011,"District of Columbia",37,2,0,0,39
"6445",2011,"Florida",35962,17283,0,3228,56473
"6446",2011,"Georgia",12130,8096,144,954,21324
"6447",2011,"Guam",8,18,2,4,32
"6448",2011,"Hawaii",0,0,0,0,0
"6449",2011,"Idaho",3003,4379,77,286,7745
"6450",2011,"Illinois",14745,12428,0,1312,28485
"6451",2011,"Indiana",15597,11489,468,884,28438
"6452",2011,"Iowa",91,4095,22,20,4228
"6453",2011,"Kansas",7648,6940,218,846,15652
"6454",2011,"Kentucky",9757,9133,139,1040,20069
"6455",2011,"Louisiana",9488,7465,206,788,17947
"6456",2011,"Maine",2931,3350,76,318,6675
"6457",2011,"Mariana Islands",0,0,0,0,0
"6458",2011,"Maryland",5037,4274,32,30,9373
"6459",2011,"Massachusetts",4439,2536,136,232,7343
"6460",2011,"Michigan",1859,12837,145,118,14959
"6461",2011,"Minnesota",7850,11543,239,628,20260
"6462",2011,"Mississippi",5510,5256,82,512,11360
"6463",2011,"Missouri",18610,13979,393,1442,34424
"6464",2011,"Montana",3072,4283,58,448,7861
"6465",2011,"Nebraska",164,2463,19,8,2654
"6466",2011,"Nevada",5549,4111,0,688,10348
"6467",2011,"New Hampshire",3272,2586,17,44,5919
"6468",2011,"New Jersey",3052,2530,0,202,5784
"6469",2011,"New Mexico",4532,4054,148,466,9200
"6470",2011,"New York",7472,14201,419,224,22316
"6471",2011,"North Carolina",356,10789,240,330,11715
"6472",2011,"North Dakota",1473,2757,39,138,4407
"6473",2011,"Ohio",26107,16404,623,1786,44920
"6474",2011,"Oklahoma",10439,8267,311,1366,20383
"6475",2011,"Oregon",9969,10516,0,1536,22021
"6476",2011,"Pennsylvania",0,71904,0,244,72148
"6477",2011,"Puerto Rico",753,158,9,16,936
"6478",2011,"Rhode Island",947,675,21,226,1869
"6479",2011,"South Carolina",8202,5130,109,424,13865
"6480",2011,"South Dakota",2256,3395,46,222,5919
"6481",2011,"Tennessee",18753,11979,0,1396,32128
"6482",2011,"Texas",39750,29342,972,3696,73760
"6483",2011,"Utah",3114,3983,0,350,7447
"6484",2011,"Vermont",1226,1538,28,86,2878
"6485",2011,"Virgin Islands",27,3,0,0,30
"6486",2011,"Virginia",18229,11780,0,1168,31177
"6487",2011,"Washington",14066,10800,598,920,26384
"6488",2011,"West Virginia",6516,6212,127,668,13523
"6489",2011,"Wisconsin",8867,13950,211,30,23058
"6490",2011,"Wyoming",2055,2079,37,206,4377
"6491",2011,"Alabama",13689,11452,147,1446,26734
"6492",2011,"Alaska",2152,2213,73,294,4732
"6493",2011,"Arizona",11824,6910,248,1016,19998
"6494",2011,"Arkansas",6696,6462,64,1042,14264
"6495",2011,"California",24348,24119,0,0,48467
"6496",2011,"Colorado",13470,11548,0,6070,31088
"6497",2011,"Connecticut",4386,3402,103,0,7891
"6498",2011,"Delaware",1011,794,33,80,1918
"6499",2011,"District of Columbia",31,2,0,0,33
"6500",2011,"Florida",37890,18121,0,3406,59417
"6501",2011,"Georgia",14936,9401,141,1378,25856
"6502",2011,"Guam",18,21,2,0,41
"6503",2011,"Hawaii",0,0,0,0,0
"6504",2011,"Idaho",2623,3710,69,392,6794
"6505",2011,"Illinois",11644,10778,0,1260,23682
"6506",2011,"Indiana",13991,9923,284,852,25050
"6507",2011,"Iowa",98,3332,26,14,3470
"6508",2011,"Kansas",6796,6162,156,786,13900
"6509",2011,"Kentucky",11819,10032,132,1738,23721
"6510",2011,"Louisiana",10137,7948,141,976,19202
"6511",2011,"Maine",2162,2379,52,210,4803
"6512",2011,"Mariana Islands",0,0,0,0,0
"6513",2011,"Maryland",4183,4158,36,22,8399
"6514",2011,"Massachusetts",3293,1637,70,188,5188
"6515",2011,"Michigan",1541,9781,120,52,11494
"6516",2011,"Minnesota",6272,8218,183,516,15189
"6517",2011,"Mississippi",6920,6109,105,748,13882
"6518",2011,"Missouri",16363,12602,358,1514,30837
"6519",2011,"Montana",2479,3348,45,516,6388
"6520",2011,"Nebraska",117,2170,8,16,2311
"6521",2011,"Nevada",5043,3362,0,664,9069
"6522",2011,"New Hampshire",2685,1941,8,16,4650
"6523",2011,"New Jersey",2467,1950,0,160,4577
"6524",2011,"New Mexico",4609,3979,113,678,9379
"6525",2011,"New York",5940,11375,363,184,17862
"6526",2011,"North Carolina",359,12774,279,590,14002
"6527",2011,"North Dakota",1268,2264,16,114,3662
"6528",2011,"Ohio",24197,14456,579,2294,41526
"6529",2011,"Oklahoma",10419,8244,292,1686,20641
"6530",2011,"Oregon",9061,9173,0,1562,19796
"6531",2011,"Pennsylvania",0,59739,0,436,60175
"6532",2011,"Puerto Rico",587,120,4,26,737
"6533",2011,"Rhode Island",812,596,27,188,1623
"6534",2011,"South Carolina",10531,5714,142,692,17079
"6535",2011,"South Dakota",1915,3108,34,216,5273
"6536",2011,"Tennessee",21069,13707,0,1722,36498
"6537",2011,"Texas",41341,29888,868,4852,76949
"6538",2011,"Utah",2916,3402,0,460,6778
"6539",2011,"Vermont",1119,1150,20,74,2363
"6540",2011,"Virgin Islands",27,0,0,0,27
"6541",2011,"Virginia",19068,12222,0,1250,32540
"6542",2011,"Washington",12701,9663,442,1140,23946
"6543",2011,"West Virginia",6537,6450,106,1194,14287
"6544",2011,"Wisconsin",7023,9639,141,22,16825
"6545",2011,"Wyoming",1556,1908,27,236,3727
"6546",2011,"Alabama",10128,9747,158,976,21009
"6547",2011,"Alaska",1794,1892,75,216,3977
"6548",2011,"Arizona",9310,6084,191,724,16309
"6549",2011,"Arkansas",4545,5179,62,544,10330
"6550",2011,"California",23418,22708,0,0,46126
"6551",2011,"Colorado",11705,10191,0,6568,28464
"6552",2011,"Connecticut",3956,3241,50,0,7247
"6553",2011,"Delaware",845,646,20,64,1575
"6554",2011,"District of Columbia",17,0,0,0,17
"6555",2011,"Florida",32684,16731,0,2840,52255
"6556",2011,"Georgia",9240,7227,100,722,17289
"6557",2011,"Guam",21,21,2,0,44
"6558",2011,"Hawaii",0,0,0,0,0
"6559",2011,"Idaho",2023,3135,45,284,5487
"6560",2011,"Illinois",10486,9844,0,1004,21334
"6561",2011,"Indiana",11783,8704,359,960,21806
"6562",2011,"Iowa",86,3028,27,8,3149
"6563",2011,"Kansas",5676,5696,146,598,12116
"6564",2011,"Kentucky",7773,7003,116,988,15880
"6565",2011,"Louisiana",8332,9008,159,678,18177
"6566",2011,"Maine",1953,2308,74,176,4511
"6567",2011,"Mariana Islands",0,1,0,0,1
"6568",2011,"Maryland",3620,3639,29,30,7318
"6569",2011,"Massachusetts",3305,1646,87,142,5180
"6570",2011,"Michigan",1389,7927,103,72,9491
"6571",2011,"Minnesota",5154,6960,129,380,12623
"6572",2011,"Mississippi",4208,5596,64,470,10338
"6573",2011,"Missouri",14075,11247,270,1134,26726
"6574",2011,"Montana",1850,2760,30,320,4960
"6575",2011,"Nebraska",139,2296,10,10,2455
"6576",2011,"Nevada",4324,3067,0,544,7935
"6577",2011,"New Hampshire",2597,1842,9,20,4468
"6578",2011,"New Jersey",2268,1759,0,132,4159
"6579",2011,"New Mexico",3527,3147,97,360,7131
"6580",2011,"New York",5387,9811,304,134,15636
"6581",2011,"North Carolina",297,9911,166,322,10696
"6582",2011,"North Dakota",930,2094,18,86,3128
"6583",2011,"Ohio",18305,11163,417,1382,31267
"6584",2011,"Oklahoma",10078,7959,227,1138,19402
"6585",2011,"Oregon",7234,7247,0,1040,15521
"6586",2011,"Pennsylvania",0,48470,0,296,48766
"6587",2011,"Puerto Rico",623,110,12,40,785
"6588",2011,"Rhode Island",669,495,16,158,1338
"6589",2011,"South Carolina",6022,4495,98,354,10969
"6590",2011,"South Dakota",1605,3000,33,184,4822
"6591",2011,"Tennessee",15601,10436,0,1034,27071
"6592",2011,"Texas",34251,28911,774,3286,67222
"6593",2011,"Utah",2628,3024,0,246,5898
"6594",2011,"Vermont",800,822,19,54,1695
"6595",2011,"Virgin Islands",16,3,0,2,21
"6596",2011,"Virginia",13928,10089,0,930,24947
"6597",2011,"Washington",10723,8083,421,744,19971
"6598",2011,"West Virginia",4288,4997,82,632,9999
"6599",2011,"Wisconsin",5558,7388,118,14,13078
"6600",2011,"Wyoming",1167,1414,32,132,2745
"6601",2010,"Alabama",13978,24298,152,1138,39566
"6602",2010,"Alaska",2553,3950,93,292,6888
"6603",2010,"Arizona",9943,9814,219,862,20838
"6604",2010,"Arkansas",5816,12455,62,514,18847
"6605",2010,"California",24519,32100,0,0,56619
"6606",2010,"Colorado",13951,16894,0,4934,35779
"6607",2010,"Connecticut",4371,4349,32,0,8752
"6608",2010,"Delaware",1003,1355,20,64,2442
"6609",2010,"District of Columbia",25,2,0,0,27
"6610",2010,"Florida",34196,27204,0,3128,64528
"6611",2010,"Georgia",12171,18708,122,1032,32033
"6612",2010,"Guam",25,20,1,4,50
"6613",2010,"Hawaii",0,0,0,0,0
"6614",2010,"Idaho",2652,5717,61,246,8676
"6615",2010,"Illinois",11217,14646,0,1072,26935
"6616",2010,"Indiana",11672,15692,236,930,28530
"6617",2010,"Iowa",76,6065,16,10,6167
"6618",2010,"Kansas",6722,10496,126,740,18084
"6619",2010,"Kentucky",10109,16321,103,1134,27667
"6620",2010,"Louisiana",10731,22440,135,942,34248
"6621",2010,"Maine",2281,4165,40,232,6718
"6622",2010,"Mariana Islands",0,0,0,0,0
"6623",2010,"Maryland",3425,6020,21,32,9498
"6624",2010,"Massachusetts",3378,2213,89,204,5884
"6625",2010,"Michigan",1559,14969,104,96,16728
"6626",2010,"Minnesota",5236,11147,145,464,16992
"6627",2010,"Mississippi",5900,17019,98,708,23725
"6628",2010,"Missouri",15736,19623,270,1318,36947
"6629",2010,"Montana",2666,5315,38,360,8379
"6630",2010,"Nebraska",172,4618,15,10,4815
"6631",2010,"Nevada",5046,4759,0,622,10427
"6632",2010,"New Hampshire",2809,2747,15,14,5585
"6633",2010,"New Jersey",2004,2778,0,130,4912
"6634",2010,"New Mexico",4431,5658,98,482,10669
"6635",2010,"New York",5392,16569,285,174,22420
"6636",2010,"North Carolina",361,22141,178,294,22974
"6637",2010,"North Dakota",984,3091,16,102,4193
"6638",2010,"Ohio",21429,22061,375,1532,45397
"6639",2010,"Oklahoma",11050,14617,232,1344,27243
"6640",2010,"Oregon",8088,12091,0,1136,21315
"6641",2010,"Pennsylvania",0,63195,0,252,63447
"6642",2010,"Puerto Rico",656,130,3,36,825
"6643",2010,"Rhode Island",746,606,16,176,1544
"6644",2010,"South Carolina",7545,11109,108,426,19188
"6645",2010,"South Dakota",1826,4931,26,192,6975
"6646",2010,"Tennessee",18915,22001,0,1404,42320
"6647",2010,"Texas",43197,60696,728,3950,108571
"6648",2010,"Utah",3663,6960,0,358,10981
"6649",2010,"Vermont",916,1391,10,54,2371
"6650",2010,"Virgin Islands",21,0,0,0,21
"6651",2010,"Virginia",14577,17746,0,1076,33399
"6652",2010,"Washington",12032,12873,366,774,26045
"6653",2010,"West Virginia",5752,10146,91,570,16559
"6654",2010,"Wisconsin",5978,11367,123,20,17488
"6655",2010,"Wyoming",1783,2838,24,168,4813
"6656",2010,"Alabama",9943,17513,122,974,28552
"6657",2010,"Alaska",1783,2776,80,232,4871
"6658",2010,"Arizona",7006,6547,171,628,14352
"6659",2010,"Arkansas",3899,10722,57,572,15250
"6660",2010,"California",18478,24984,0,0,43462
"6661",2010,"Colorado",9975,12773,0,5888,28636
"6662",2010,"Connecticut",3878,3972,48,0,7898
"6663",2010,"Delaware",805,1212,15,52,2084
"6664",2010,"District of Columbia",21,0,0,0,21
"6665",2010,"Florida",27691,19404,0,2732,49827
"6666",2010,"Georgia",7602,11566,93,788,20049
"6667",2010,"Guam",18,22,1,2,43
"6668",2010,"Hawaii",0,0,0,0,0
"6669",2010,"Idaho",1692,3661,29,200,5582
"6670",2010,"Illinois",9128,13938,0,1036,24102
"6671",2010,"Indiana",8862,14956,185,796,24799
"6672",2010,"Iowa",40,6199,10,10,6259
"6673",2010,"Kansas",4980,8773,106,586,14445
"6674",2010,"Kentucky",6776,13152,91,1004,21023
"6675",2010,"Louisiana",7413,16069,108,700,24290
"6676",2010,"Maine",1855,3824,34,180,5893
"6677",2010,"Mariana Islands",0,0,0,0,0
"6678",2010,"Maryland",3175,6327,23,22,9547
"6679",2010,"Massachusetts",2569,2280,49,150,5048
"6680",2010,"Michigan",1303,17554,88,92,19037
"6681",2010,"Minnesota",4196,11475,100,304,16075
"6682",2010,"Mississippi",4088,13772,114,494,18468
"6683",2010,"Missouri",11684,17214,240,1056,30194
"6684",2010,"Montana",1767,3879,20,318,5984
"6685",2010,"Nebraska",91,3930,14,6,4041
"6686",2010,"Nevada",3774,3365,0,490,7629
"6687",2010,"New Hampshire",2412,2639,10,12,5073
"6688",2010,"New Jersey",2102,2903,0,162,5167
"6689",2010,"New Mexico",3186,3819,70,400,7475
"6690",2010,"New York",4811,18366,218,156,23551
"6691",2010,"North Carolina",275,16136,158,282,16851
"6692",2010,"North Dakota",792,3071,13,108,3984
"6693",2010,"Ohio",16886,22161,333,1288,40668
"6694",2010,"Oklahoma",8321,11041,262,1194,20818
"6695",2010,"Oregon",5850,8826,0,904,15580
"6696",2010,"Pennsylvania",1,67043,0,390,67434
"6697",2010,"Puerto Rico",542,102,2,34,680
"6698",2010,"Rhode Island",652,570,16,186,1424
"6699",2010,"South Carolina",7017,8934,96,578,16625
"6700",2010,"South Dakota",1312,4787,25,176,6300
"6701",2010,"Tennessee",14304,17217,0,1158,32679
"6702",2010,"Texas",31451,40228,614,3244,75537
"6703",2010,"Utah",2500,4273,0,320,7093
"6704",2010,"Vermont",629,1615,26,44,2314
"6705",2010,"Virgin Islands",14,1,0,0,15
"6706",2010,"Virginia",12715,16299,0,956,29970
"6707",2010,"Washington",9230,8812,272,666,18980
"6708",2010,"West Virginia",3991,10722,59,662,15434
"6709",2010,"Wisconsin",5242,15123,122,24,20511
"6710",2010,"Wyoming",1082,1911,23,124,3140
"6711",2010,"Alabama",8410,12198,108,866,21582
"6712",2010,"Alaska",2399,3513,88,388,6388
"6713",2010,"Arizona",7142,5384,159,640,13325
"6714",2010,"Arkansas",3462,7811,55,524,11852
"6715",2010,"California",21351,22352,0,0,43703
"6716",2010,"Colorado",10017,11714,0,3060,24791
"6717",2010,"Connecticut",3782,3840,33,0,7655
"6718",2010,"Delaware",735,947,10,56,1748
"6719",2010,"District of Columbia",25,1,0,0,26
"6720",2010,"Florida",26902,15965,0,2716,45583
"6721",2010,"Georgia",7606,10062,87,736,18491
"6722",2010,"Guam",14,25,2,4,45
"6723",2010,"Hawaii",0,0,0,0,0
"6724",2010,"Idaho",1798,4213,31,248,6290
"6725",2010,"Illinois",8918,10462,0,724,20104
"6726",2010,"Indiana",9477,11402,240,696,21815
"6727",2010,"Iowa",42,4289,8,12,4351
"6728",2010,"Kansas",4950,6760,114,576,12400
"6729",2010,"Kentucky",6796,9734,93,996,17619
"6730",2010,"Louisiana",6792,14282,121,686,21881
"6731",2010,"Maine",2141,5938,33,262,8374
"6732",2010,"Mariana Islands",0,0,0,0,0
"6733",2010,"Maryland",2997,4430,18,34,7479
"6734",2010,"Massachusetts",2805,2099,49,186,5139
"6735",2010,"Michigan",1301,13893,111,112,15417
"6736",2010,"Minnesota",5018,17640,119,428,23205
"6737",2010,"Mississippi",3761,8297,89,506,12653
"6738",2010,"Missouri",11534,15056,215,1512,28317
"6739",2010,"Montana",1902,5855,38,388,8183
"6740",2010,"Nebraska",89,3338,10,14,3451
"6741",2010,"Nevada",3529,2744,0,486,6759
"6742",2010,"New Hampshire",2570,3131,15,16,5732
"6743",2010,"New Jersey",2122,2223,0,156,4501
"6744",2010,"New Mexico",3322,3385,78,378,7163
"6745",2010,"New York",5056,16813,219,156,22244
"6746",2010,"North Carolina",230,11897,169,332,12628
"6747",2010,"North Dakota",879,4913,21,132,5945
"6748",2010,"Ohio",16955,14932,390,1448,33725
"6749",2010,"Oklahoma",6962,8168,172,1096,16398
"6750",2010,"Oregon",6053,8402,0,1018,15473
"6751",2010,"Pennsylvania",1,56795,0,210,57006
"6752",2010,"Puerto Rico",494,88,1,28,611
"6753",2010,"Rhode Island",625,578,22,162,1387
"6754",2010,"South Carolina",4512,5403,73,360,10348
"6755",2010,"South Dakota",1360,6299,21,190,7870
"6756",2010,"Tennessee",12943,12387,0,1096,26426
"6757",2010,"Texas",25858,33053,565,3014,62490
"6758",2010,"Utah",1995,3593,0,250,5838
"6759",2010,"Vermont",776,1757,18,82,2633
"6760",2010,"Virgin Islands",21,2,0,0,23
"6761",2010,"Virginia",12655,12674,0,884,26213
"6762",2010,"Washington",9138,9407,315,820,19680
"6763",2010,"West Virginia",4156,8515,57,652,13380
"6764",2010,"Wisconsin",5887,15155,121,28,21191
"6765",2010,"Wyoming",938,1922,14,106,2980
"6766",2010,"Alabama",8294,10525,124,830,19773
"6767",2010,"Alaska",1767,2840,60,250,4917
"6768",2010,"Arizona",7342,5704,133,570,13749
"6769",2010,"Arkansas",3619,6236,57,568,10480
"6770",2010,"California",18221,20434,0,0,38655
"6771",2010,"Colorado",9991,10435,0,2854,23280
"6772",2010,"Connecticut",3678,3328,37,0,7043
"6773",2010,"Delaware",717,808,18,56,1599
"6774",2010,"District of Columbia",27,1,0,0,28
"6775",2010,"Florida",25405,13802,0,2478,41685
"6776",2010,"Georgia",6953,7373,93,646,15065
"6777",2010,"Guam",17,23,0,2,42
"6778",2010,"Hawaii",0,0,0,0,0
"6779",2010,"Idaho",1886,4020,37,262,6205
"6780",2010,"Illinois",8469,9115,0,930,18514
"6781",2010,"Indiana",8301,8792,167,586,17846
"6782",2010,"Iowa",35,3312,11,10,3368
"6783",2010,"Kansas",4118,5348,89,602,10157
"6784",2010,"Kentucky",6340,7758,78,1028,15204
"6785",2010,"Louisiana",8185,13822,155,912,23074
"6786",2010,"Maine",2072,4309,45,236,6662
"6787",2010,"Mariana Islands",0,0,0,0,0
"6788",2010,"Maryland",2859,3701,14,26,6600
"6789",2010,"Massachusetts",2501,1839,71,168,4579
"6790",2010,"Michigan",1213,12889,118,96,14316
"6791",2010,"Minnesota",4832,15363,116,420,20731
"6792",2010,"Mississippi",3556,6433,56,476,10521
"6793",2010,"Missouri",11250,11432,194,1060,23936
"6794",2010,"Montana",2109,4679,23,358,7169
"6795",2010,"Nebraska",65,2418,6,10,2499
"6796",2010,"Nevada",3393,2757,0,460,6610
"6797",2010,"New Hampshire",2321,2615,8,10,4954
"6798",2010,"New Jersey",2033,1972,0,142,4147
"6799",2010,"New Mexico",3302,3324,69,358,7053
"6800",2010,"New York",4967,14319,274,136,19696
"6801",2010,"North Carolina",207,9925,162,266,10560
"6802",2010,"North Dakota",818,3270,16,92,4196
"6803",2010,"Ohio",14875,12466,296,1294,28931
"6804",2010,"Oklahoma",6721,6944,166,1112,14943
"6805",2010,"Oregon",6389,9154,0,934,16477
"6806",2010,"Pennsylvania",0,51739,0,180,51919
"6807",2010,"Puerto Rico",520,169,4,26,719
"6808",2010,"Rhode Island",588,506,6,156,1256
"6809",2010,"South Carolina",4892,5055,53,368,10368
"6810",2010,"South Dakota",1362,4227,20,150,5759
"6811",2010,"Tennessee",12033,10387,0,1016,23436
"6812",2010,"Texas",24093,34038,529,2874,61534
"6813",2010,"Utah",2045,3423,0,236,5704
"6814",2010,"Vermont",849,1451,11,66,2377
"6815",2010,"Virgin Islands",32,4,0,2,38
"6816",2010,"Virginia",11106,10776,0,864,22746
"6817",2010,"Washington",8816,9005,284,758,18863
"6818",2010,"West Virginia",3630,6102,48,600,10380
"6819",2010,"Wisconsin",5199,12920,120,26,18265
"6820",2010,"Wyoming",1120,2036,21,150,3327
"6821",2010,"Alabama",9180,10361,142,914,20597
"6822",2010,"Alaska",1998,3168,67,206,5439
"6823",2010,"Arizona",7333,5615,147,596,13691
"6824",2010,"Arkansas",3431,4670,50,540,8691
"6825",2010,"California",18686,22110,0,0,40796
"6826",2010,"Colorado",11216,10872,0,3464,25552
"6827",2010,"Connecticut",3786,3259,28,0,7073
"6828",2010,"Delaware",698,687,19,28,1432
"6829",2010,"District of Columbia",21,0,0,0,21
"6830",2010,"Florida",25610,13532,0,2486,41628
"6831",2010,"Georgia",7000,6602,85,598,14285
"6832",2010,"Guam",25,19,4,4,52
"6833",2010,"Hawaii",0,0,0,0,0
"6834",2010,"Idaho",1763,3249,23,244,5279
"6835",2010,"Illinois",8621,8960,0,740,18321
"6836",2010,"Indiana",9467,8859,218,734,19278
"6837",2010,"Iowa",40,2496,6,0,2542
"6838",2010,"Kansas",4222,4949,108,482,9761
"6839",2010,"Kentucky",5882,6494,75,842,13293
"6840",2010,"Louisiana",7036,9750,111,608,17505
"6841",2010,"Maine",1751,3005,45,188,4989
"6842",2010,"Mariana Islands",0,0,0,0,0
"6843",2010,"Maryland",3378,3256,13,32,6679
"6844",2010,"Massachusetts",2805,1673,62,208,4748
"6845",2010,"Michigan",1266,9877,93,98,11334
"6846",2010,"Minnesota",4782,10143,97,374,15396
"6847",2010,"Mississippi",3999,5824,71,496,10390
"6848",2010,"Missouri",11357,10602,211,946,23116
"6849",2010,"Montana",2443,3940,50,334,6767
"6850",2010,"Nebraska",51,2127,10,2,2190
"6851",2010,"Nevada",3608,2911,0,434,6953
"6852",2010,"New Hampshire",2247,2050,11,2,4310
"6853",2010,"New Jersey",1975,1746,0,160,3881
"6854",2010,"New Mexico",3488,3155,96,396,7135
"6855",2010,"New York",4713,10271,182,178,15344
"6856",2010,"North Carolina",223,9248,169,254,9894
"6857",2010,"North Dakota",805,2342,14,94,3255
"6858",2010,"Ohio",14235,11330,380,1140,27085
"6859",2010,"Oklahoma",7200,6992,161,1002,15355
"6860",2010,"Oregon",6148,6995,0,962,14105
"6861",2010,"Pennsylvania",0,47082,0,242,47324
"6862",2010,"Puerto Rico",556,167,4,30,757
"6863",2010,"Rhode Island",586,479,19,134,1218
"6864",2010,"South Carolina",4466,4578,55,314,9413
"6865",2010,"South Dakota",1270,3064,13,162,4509
"6866",2010,"Tennessee",12546,10049,0,1038,23633
"6867",2010,"Texas",25618,30875,598,2840,59931
"6868",2010,"Utah",1873,2778,0,260,4911
"6869",2010,"Vermont",693,964,8,66,1731
"6870",2010,"Virgin Islands",19,1,0,0,20
"6871",2010,"Virginia",11857,10207,0,1032,23096
"6872",2010,"Washington",9030,7578,276,708,17592
"6873",2010,"West Virginia",3601,4766,41,536,8944
"6874",2010,"Wisconsin",5110,9711,94,10,14925
"6875",2010,"Wyoming",1160,1636,16,154,2966
"6876",2010,"Alabama",8451,7714,135,758,17058
"6877",2010,"Alaska",2193,2355,44,268,4860
"6878",2010,"Arizona",6933,4405,177,580,12095
"6879",2010,"Arkansas",3377,3587,60,442,7466
"6880",2010,"California",19019,19505,0,0,38524
"6881",2010,"Colorado",9883,8632,0,3214,21729
"6882",2010,"Connecticut",3522,2507,32,0,6061
"6883",2010,"Delaware",680,557,14,42,1293
"6884",2010,"District of Columbia",31,0,0,0,31
"6885",2010,"Florida",25729,12007,0,2372,40108
"6886",2010,"Georgia",6734,4676,99,618,12127
"6887",2010,"Guam",20,20,2,2,44
"6888",2010,"Hawaii",0,0,0,0,0
"6889",2010,"Idaho",1638,2511,44,182,4375
"6890",2010,"Illinois",7950,6957,0,976,15883
"6891",2010,"Indiana",7672,6279,150,502,14603
"6892",2010,"Iowa",50,1700,5,2,1757
"6893",2010,"Kansas",3951,3402,83,402,7838
"6894",2010,"Kentucky",5885,5426,93,796,12200
"6895",2010,"Louisiana",6805,6112,142,572,13631
"6896",2010,"Maine",1583,2207,33,180,4003
"6897",2010,"Mariana Islands",0,0,0,0,0
"6898",2010,"Maryland",3147,2703,16,28,5894
"6899",2010,"Massachusetts",2412,1491,69,162,4134
"6900",2010,"Michigan",1264,6504,82,100,7950
"6901",2010,"Minnesota",4091,6283,100,284,10758
"6902",2010,"Mississippi",3685,3750,57,446,7938
"6903",2010,"Missouri",10845,7545,208,898,19496
"6904",2010,"Montana",1957,2960,36,346,5299
"6905",2010,"Nebraska",79,1348,5,8,1440
"6906",2010,"Nevada",3329,2336,0,432,6097
"6907",2010,"New Hampshire",2152,2137,8,8,4305
"6908",2010,"New Jersey",2107,1547,0,146,3800
"6909",2010,"New Mexico",3225,2778,64,370,6437
"6910",2010,"New York",4496,8367,162,144,13169
"6911",2010,"North Carolina",240,7092,152,306,7790
"6912",2010,"North Dakota",676,1728,12,76,2492
"6913",2010,"Ohio",14141,9700,291,1106,25238
"6914",2010,"Oklahoma",6836,5338,159,1000,13333
"6915",2010,"Oregon",5966,5944,0,886,12796
"6916",2010,"Pennsylvania",2,42637,0,324,42963
"6917",2010,"Puerto Rico",561,151,1,44,757
"6918",2010,"Rhode Island",543,375,18,108,1044
"6919",2010,"South Carolina",4637,3180,51,268,8136
"6920",2010,"South Dakota",1185,2234,17,124,3560
"6921",2010,"Tennessee",12405,8038,0,946,21389
"6922",2010,"Texas",25133,21903,559,2740,50335
"6923",2010,"Utah",1906,2291,0,212,4409
"6924",2010,"Vermont",680,800,22,42,1544
"6925",2010,"Virgin Islands",16,2,0,0,18
"6926",2010,"Virginia",12207,8592,0,946,21745
"6927",2010,"Washington",8360,6550,280,764,15954
"6928",2010,"West Virginia",3387,3690,55,564,7696
"6929",2010,"Wisconsin",4188,6434,67,20,10709
"6930",2010,"Wyoming",1023,1294,13,104,2434
"6931",2010,"Alabama",8251,6608,153,724,15736
"6932",2010,"Alaska",2316,2236,64,194,4810
"6933",2010,"Arizona",6144,4484,167,468,11263
"6934",2010,"Arkansas",3409,3134,33,426,7002
"6935",2010,"California",17778,18802,0,0,36580
"6936",2010,"Colorado",9795,8378,0,3620,21793
"6937",2010,"Connecticut",3644,2989,29,0,6662
"6938",2010,"Delaware",645,524,19,68,1256
"6939",2010,"District of Columbia",19,2,0,0,21
"6940",2010,"Florida",24424,11565,0,2478,38467
"6941",2010,"Georgia",6093,4332,87,516,11028
"6942",2010,"Guam",12,16,0,2,30
"6943",2010,"Hawaii",0,0,0,0,0
"6944",2010,"Idaho",1681,2762,28,212,4683
"6945",2010,"Illinois",7818,6701,1,784,15304
"6946",2010,"Indiana",7950,6307,228,608,15093
"6947",2010,"Iowa",54,1938,9,4,2005
"6948",2010,"Kansas",3638,3443,91,362,7534
"6949",2010,"Kentucky",5223,4634,90,798,10745
"6950",2010,"Louisiana",6170,5091,131,480,11872
"6951",2010,"Maine",1796,2188,28,190,4202
"6952",2010,"Mariana Islands",0,0,0,0,0
"6953",2010,"Maryland",2898,2663,16,20,5597
"6954",2010,"Massachusetts",2387,1464,80,150,4081
"6955",2010,"Michigan",1312,6790,98,80,8280
"6956",2010,"Minnesota",4255,6687,96,314,11352
"6957",2010,"Mississippi",3282,3117,57,378,6834
"6958",2010,"Missouri",11293,7782,200,956,20231
"6959",2010,"Montana",1979,3358,43,316,5696
"6960",2010,"Nebraska",66,1473,8,16,1563
"6961",2010,"Nevada",3399,2595,0,462,6456
"6962",2010,"New Hampshire",2075,1890,14,14,3993
"6963",2010,"New Jersey",2159,1552,0,152,3863
"6964",2010,"New Mexico",3141,2767,71,480,6459
"6965",2010,"New York",5010,8535,212,138,13895
"6966",2010,"North Carolina",226,6657,166,240,7289
"6967",2010,"North Dakota",686,1741,16,72,2515
"6968",2010,"Ohio",12808,8904,259,1026,22997
"6969",2010,"Oklahoma",6406,4550,158,900,12014
"6970",2010,"Oregon",6223,6549,0,888,13660
"6971",2010,"Pennsylvania",0,42880,0,232,43112
"6972",2010,"Puerto Rico",504,127,4,30,665
"6973",2010,"Rhode Island",531,433,15,130,1109
"6974",2010,"South Carolina",4560,2818,49,264,7691
"6975",2010,"South Dakota",1177,2174,15,152,3518
"6976",2010,"Tennessee",11699,6858,0,906,19463
"6977",2010,"Texas",24420,19503,549,2440,46912
"6978",2010,"Utah",1910,2565,0,228,4703
"6979",2010,"Vermont",684,716,8,50,1458
"6980",2010,"Virgin Islands",18,1,0,0,19
"6981",2010,"Virginia",9347,6917,0,776,17040
"6982",2010,"Washington",9015,7126,274,744,17159
"6983",2010,"West Virginia",3599,3615,64,444,7722
"6984",2010,"Wisconsin",4254,6869,89,6,11218
"6985",2010,"Wyoming",1156,1439,18,92,2705
"6986",2010,"Alabama",8028,6946,150,742,15866
"6987",2010,"Alaska",2298,2552,39,236,5125
"6988",2010,"Arizona",7261,4744,143,576,12724
"6989",2010,"Arkansas",3353,3225,41,334,6953
"6990",2010,"California",19464,20997,0,0,40461
"6991",2010,"Colorado",10056,8534,0,3190,21780
"6992",2010,"Connecticut",3574,2706,34,0,6314
"6993",2010,"Delaware",640,541,20,52,1253
"6994",2010,"District of Columbia",24,1,0,0,25
"6995",2010,"Florida",25428,11640,0,2214,39282
"6996",2010,"Georgia",6477,4553,74,456,11560
"6997",2010,"Guam",23,22,1,0,46
"6998",2010,"Hawaii",0,0,0,0,0
"6999",2010,"Idaho",1868,2970,39,222,5099
"7000",2010,"Illinois",8304,7071,0,624,15999
"7001",2010,"Indiana",7761,6257,216,556,14790
"7002",2010,"Iowa",44,1732,12,6,1794
"7003",2010,"Kansas",3782,3634,102,456,7974
"7004",2010,"Kentucky",5486,5056,79,682,11303
"7005",2010,"Louisiana",6047,4511,146,416,11120
"7006",2010,"Maine",1685,2206,32,176,4099
"7007",2010,"Mariana Islands",0,0,0,0,0
"7008",2010,"Maryland",3220,2724,16,6,5966
"7009",2010,"Massachusetts",2501,1443,79,162,4185
"7010",2010,"Michigan",1552,7455,115,72,9194
"7011",2010,"Minnesota",4672,6238,112,348,11370
"7012",2010,"Mississippi",3540,3054,71,360,7025
"7013",2010,"Missouri",10851,7698,194,856,19599
"7014",2010,"Montana",1977,3426,44,288,5735
"7015",2010,"Nebraska",100,1387,4,2,1493
"7016",2010,"Nevada",3919,2883,0,564,7366
"7017",2010,"New Hampshire",2021,1857,16,12,3906
"7018",2010,"New Jersey",2189,1646,0,154,3989
"7019",2010,"New Mexico",3385,2792,92,336,6605
"7020",2010,"New York",4774,8957,224,146,14101
"7021",2010,"North Carolina",206,7040,150,236,7632
"7022",2010,"North Dakota",744,1874,20,60,2698
"7023",2010,"Ohio",14214,9410,332,1030,24986
"7024",2010,"Oklahoma",7131,4952,160,922,13165
"7025",2010,"Oregon",6477,7125,0,900,14502
"7026",2010,"Pennsylvania",0,41483,0,236,41719
"7027",2010,"Puerto Rico",491,109,2,22,624
"7028",2010,"Rhode Island",569,393,23,134,1119
"7029",2010,"South Carolina",4641,2845,58,310,7854
"7030",2010,"South Dakota",1309,2218,33,158,3718
"7031",2010,"Tennessee",11886,6961,0,836,19683
"7032",2010,"Texas",24476,19923,557,2380,47336
"7033",2010,"Utah",2192,2682,0,216,5090
"7034",2010,"Vermont",761,826,16,70,1673
"7035",2010,"Virgin Islands",11,5,0,2,18
"7036",2010,"Virginia",15652,11525,0,1092,28269
"7037",2010,"Washington",9214,7521,321,608,17664
"7038",2010,"West Virginia",3498,3594,36,438,7566
"7039",2010,"Wisconsin",4439,6821,105,6,11371
"7040",2010,"Wyoming",1193,1687,42,130,3052
"7041",2010,"Alabama",8727,8095,131,788,17741
"7042",2010,"Alaska",2650,3136,64,270,6120
"7043",2010,"Arizona",7787,5097,198,618,13700
"7044",2010,"Arkansas",3865,3833,45,394,8137
"7045",2010,"California",26170,27650,0,0,53820
"7046",2010,"Colorado",10998,9403,0,6416,26817
"7047",2010,"Connecticut",3994,3098,97,0,7189
"7048",2010,"Delaware",772,626,17,48,1463
"7049",2010,"District of Columbia",29,1,0,0,30
"7050",2010,"Florida",26817,12952,0,2414,42183
"7051",2010,"Georgia",7215,4897,95,554,12761
"7052",2010,"Guam",13,19,2,2,36
"7053",2010,"Hawaii",0,0,0,0,0
"7054",2010,"Idaho",1982,3133,44,178,5337
"7055",2010,"Illinois",8557,8005,0,926,17488
"7056",2010,"Indiana",8149,7473,227,546,16395
"7057",2010,"Iowa",37,2442,13,10,2502
"7058",2010,"Kansas",4268,4182,107,524,9081
"7059",2010,"Kentucky",6274,6352,104,880,13610
"7060",2010,"Louisiana",6363,4992,114,568,12037
"7061",2010,"Maine",2078,2575,49,280,4982
"7062",2010,"Mariana Islands",0,0,0,0,0
"7063",2010,"Maryland",3671,3136,17,24,6848
"7064",2010,"Massachusetts",2791,1778,71,162,4802
"7065",2010,"Michigan",1636,8860,143,126,10765
"7066",2010,"Minnesota",5514,9001,141,422,15078
"7067",2010,"Mississippi",3883,3256,59,394,7592
"7068",2010,"Missouri",11550,9599,199,1040,22388
"7069",2010,"Montana",2172,3824,65,364,6425
"7070",2010,"Nebraska",87,1637,5,2,1731
"7071",2010,"Nevada",4284,3138,0,518,7940
"7072",2010,"New Hampshire",2592,2392,17,26,5027
"7073",2010,"New Jersey",2322,1820,0,146,4288
"7074",2010,"New Mexico",3469,3251,75,362,7157
"7075",2010,"New York",5313,11554,270,168,17305
"7076",2010,"North Carolina",203,7514,169,296,8182
"7077",2010,"North Dakota",888,2004,16,76,2984
"7078",2010,"Ohio",17333,11342,329,1270,30274
"7079",2010,"Oklahoma",8038,6220,235,1026,15519
"7080",2010,"Oregon",7445,8065,0,972,16482
"7081",2010,"Pennsylvania",1,49644,0,786,50431
"7082",2010,"Puerto Rico",530,104,1,14,649
"7083",2010,"Rhode Island",633,483,19,128,1263
"7084",2010,"South Carolina",5313,3336,60,304,9013
"7085",2010,"South Dakota",1396,2785,19,176,4376
"7086",2010,"Tennessee",12533,8066,0,926,21525
"7087",2010,"Texas",24481,21343,595,2464,48883
"7088",2010,"Utah",2379,2996,0,286,5661
"7089",2010,"Vermont",830,1181,11,62,2084
"7090",2010,"Virgin Islands",15,1,0,0,16
"7091",2010,"Virginia",25259,18158,0,1440,44857
"7092",2010,"Washington",10384,7986,347,738,19455
"7093",2010,"West Virginia",3927,4534,53,526,9040
"7094",2010,"Wisconsin",5414,10701,108,14,16237
"7095",2010,"Wyoming",1295,1700,38,164,3197
"7096",2010,"Alabama",11242,10951,179,936,23308
"7097",2010,"Alaska",2297,2735,81,248,5361
"7098",2010,"Arizona",7463,5783,180,660,14086
"7099",2010,"Arkansas",5632,5082,60,522,11296
"7100",2010,"California",23487,25449,0,0,48936
"7101",2010,"Colorado",12245,11297,0,6478,30020
"7102",2010,"Connecticut",4842,3959,58,0,8859
"7103",2010,"Delaware",1024,790,29,70,1913
"7104",2010,"District of Columbia",38,1,0,0,39
"7105",2010,"Florida",32241,16265,0,2922,51428
"7106",2010,"Georgia",10166,7367,144,768,18445
"7107",2010,"Guam",28,28,3,2,61
"7108",2010,"Hawaii",0,0,0,0,0
"7109",2010,"Idaho",2240,3694,55,288,6277
"7110",2010,"Illinois",11425,11398,0,1342,24165
"7111",2010,"Indiana",12071,10378,386,842,23677
"7112",2010,"Iowa",73,4220,12,10,4315
"7113",2010,"Kansas",6180,5547,155,538,12420
"7114",2010,"Kentucky",8521,8143,126,942,17732
"7115",2010,"Louisiana",8470,7264,199,670,16603
"7116",2010,"Maine",2495,3053,43,272,5863
"7117",2010,"Mariana Islands",0,0,0,0,0
"7118",2010,"Maryland",4343,3889,22,22,8276
"7119",2010,"Massachusetts",3401,2105,109,202,5817
"7120",2010,"Michigan",2199,11678,161,110,14148
"7121",2010,"Minnesota",6581,10129,156,492,17358
"7122",2010,"Mississippi",5106,5257,104,468,10935
"7123",2010,"Missouri",15617,12253,341,1100,29311
"7124",2010,"Montana",2383,4352,46,346,7127
"7125",2010,"Nebraska",62,2201,8,14,2285
"7126",2010,"Nevada",4820,3390,0,498,8708
"7127",2010,"New Hampshire",2791,2354,17,14,5176
"7128",2010,"New Jersey",2707,2159,0,160,5026
"7129",2010,"New Mexico",4443,4068,115,480,9106
"7130",2010,"New York",6093,12810,380,182,19465
"7131",2010,"North Carolina",281,9850,213,272,10616
"7132",2010,"North Dakota",1108,2342,21,98,3569
"7133",2010,"Ohio",21508,14073,456,1420,37457
"7134",2010,"Oklahoma",8887,7274,257,1026,17444
"7135",2010,"Oregon",8050,9568,0,1322,18940
"7136",2010,"Pennsylvania",1,65524,0,288,65813
"7137",2010,"Puerto Rico",559,117,1,28,705
"7138",2010,"Rhode Island",803,636,23,160,1622
"7139",2010,"South Carolina",7391,4645,89,428,12553
"7140",2010,"South Dakota",1715,3283,32,194,5224
"7141",2010,"Tennessee",15605,10938,0,1148,27691
"7142",2010,"Texas",31512,25440,765,2908,60625
"7143",2010,"Utah",2762,3486,0,300,6548
"7144",2010,"Vermont",1081,1495,14,80,2670
"7145",2010,"Virgin Islands",7,2,0,0,9
"7146",2010,"Virginia",18718,11119,0,758,30595
"7147",2010,"Washington",11607,9443,439,742,22231
"7148",2010,"West Virginia",5216,5857,113,690,11876
"7149",2010,"Wisconsin",6911,14209,163,32,21315
"7150",2010,"Wyoming",1473,1934,34,168,3609
"7151",2010,"Alabama",13055,11229,222,1226,25732
"7152",2010,"Alaska",1934,2104,78,234,4350
"7153",2010,"Arizona",8329,6312,196,770,15607
"7154",2010,"Arkansas",6346,6412,61,910,13729
"7155",2010,"California",19706,21016,0,0,40722
"7156",2010,"Colorado",11557,10569,0,5764,27890
"7157",2010,"Connecticut",4327,3223,22,0,7572
"7158",2010,"Delaware",726,627,14,40,1407
"7159",2010,"District of Columbia",28,1,0,0,29
"7160",2010,"Florida",30890,16415,0,2536,49841
"7161",2010,"Georgia",12525,8331,121,1038,22015
"7162",2010,"Guam",19,29,0,8,56
"7163",2010,"Hawaii",0,0,0,0,0
"7164",2010,"Idaho",2150,3451,43,318,5962
"7165",2010,"Illinois",9998,10190,0,1218,21406
"7166",2010,"Indiana",11285,9441,302,762,21790
"7167",2010,"Iowa",61,3259,20,10,3350
"7168",2010,"Kansas",5920,5742,135,730,12527
"7169",2010,"Kentucky",9886,9557,138,1622,21203
"7170",2010,"Louisiana",9146,7329,207,746,17428
"7171",2010,"Maine",2053,2462,37,232,4784
"7172",2010,"Mariana Islands",0,0,0,0,0
"7173",2010,"Maryland",3322,3343,35,42,6742
"7174",2010,"Massachusetts",2858,1628,160,174,4820
"7175",2010,"Michigan",2017,10098,155,100,12370
"7176",2010,"Minnesota",4957,7188,141,344,12630
"7177",2010,"Mississippi",6188,5762,84,690,12724
"7178",2010,"Missouri",16080,12779,283,1312,30454
"7179",2010,"Montana",2132,3558,41,482,6213
"7180",2010,"Nebraska",23,1864,8,4,1899
"7181",2010,"Nevada",4013,3119,0,576,7708
"7182",2010,"New Hampshire",2452,2150,18,10,4630
"7183",2010,"New Jersey",1915,1675,0,130,3720
"7184",2010,"New Mexico",4232,3940,95,438,8705
"7185",2010,"New York",4702,10776,272,124,15874
"7186",2010,"North Carolina",325,11629,208,544,12706
"7187",2010,"North Dakota",868,1943,20,72,2903
"7188",2010,"Ohio",18528,12089,408,1626,32651
"7189",2010,"Oklahoma",10593,8169,262,1542,20566
"7190",2010,"Oregon",7376,8846,0,1254,17476
"7191",2010,"Pennsylvania",0,47152,0,130,47282
"7192",2010,"Puerto Rico",490,121,3,42,656
"7193",2010,"Rhode Island",717,499,16,168,1400
"7194",2010,"South Carolina",9261,5147,98,556,15062
"7195",2010,"South Dakota",1518,2978,34,192,4722
"7196",2010,"Tennessee",18309,12832,0,1476,32617
"7197",2010,"Texas",36493,27823,939,4024,69279
"7198",2010,"Utah",2861,3624,0,374,6859
"7199",2010,"Vermont",989,1194,19,64,2266
"7200",2010,"Virgin Islands",17,1,0,2,20
"7201",2010,"Virginia",14130,11132,0,716,25978
"7202",2010,"Washington",11162,9260,386,880,21688
"7203",2010,"West Virginia",4859,5705,95,798,11457
"7204",2010,"Wisconsin",5615,9841,147,14,15617
"7205",2010,"Wyoming",1330,1680,34,180,3224
"7206",2010,"Alabama",9404,10081,153,1034,20672
"7207",2010,"Alaska",1532,1812,67,220,3631
"7208",2010,"Arizona",6479,5178,201,568,12426
"7209",2010,"Arkansas",3783,5039,55,544,9421
"7210",2010,"California",18280,20059,0,0,38339
"7211",2010,"Colorado",10471,10141,0,7306,27918
"7212",2010,"Connecticut",4147,3316,20,0,7483
"7213",2010,"Delaware",785,792,12,98,1687
"7214",2010,"District of Columbia",20,1,0,0,21
"7215",2010,"Florida",27038,15924,0,2606,45568
"7216",2010,"Georgia",8603,7074,123,806,16606
"7217",2010,"Guam",26,25,1,2,54
"7218",2010,"Hawaii",0,0,0,0,0
"7219",2010,"Idaho",1731,2693,33,236,4693
"7220",2010,"Illinois",8799,9303,0,928,19030
"7221",2010,"Indiana",9948,8614,294,732,19588
"7222",2010,"Iowa",36,2748,16,8,2808
"7223",2010,"Kansas",5077,5286,144,558,11065
"7224",2010,"Kentucky",7133,7283,107,1062,15585
"7225",2010,"Louisiana",6607,7589,131,610,14937
"7226",2010,"Maine",1590,2036,34,154,3814
"7227",2010,"Mariana Islands",0,0,0,0,0
"7228",2010,"Maryland",3474,3364,20,18,6876
"7229",2010,"Massachusetts",3060,1890,113,148,5211
"7230",2010,"Michigan",1901,8441,129,106,10577
"7231",2010,"Minnesota",4478,6191,161,326,11156
"7232",2010,"Mississippi",3800,5394,59,484,9737
"7233",2010,"Missouri",12126,10374,270,928,23698
"7234",2010,"Montana",1596,3017,40,354,5007
"7235",2010,"Nebraska",12,1800,5,2,1819
"7236",2010,"Nevada",3511,2806,0,492,6809
"7237",2010,"New Hampshire",2346,1998,11,12,4367
"7238",2010,"New Jersey",1958,2011,0,138,4107
"7239",2010,"New Mexico",2994,3356,73,292,6715
"7240",2010,"New York",4521,10202,252,116,15091
"7241",2010,"North Carolina",230,9770,165,356,10521
"7242",2010,"North Dakota",684,1895,17,68,2664
"7243",2010,"Ohio",16178,11272,435,1338,29223
"7244",2010,"Oklahoma",7104,6793,203,1004,15104
"7245",2010,"Oregon",5995,6714,0,844,13553
"7246",2010,"Pennsylvania",0,47194,0,190,47384
"7247",2010,"Puerto Rico",483,87,1,52,623
"7248",2010,"Rhode Island",648,504,21,194,1367
"7249",2010,"South Carolina",6079,4278,93,400,10850
"7250",2010,"South Dakota",1194,2423,29,156,3802
"7251",2010,"Tennessee",12900,9816,0,934,23650
"7252",2010,"Texas",27645,26553,746,3054,57998
"7253",2010,"Utah",2356,2824,0,228,5408
"7254",2010,"Vermont",647,801,25,44,1517
"7255",2010,"Virgin Islands",21,2,0,0,23
"7256",2010,"Virginia",11513,10323,0,618,22454
"7257",2010,"Washington",9348,8287,471,772,18878
"7258",2010,"West Virginia",3735,4860,61,684,9340
"7259",2010,"Wisconsin",4382,7950,153,14,12499
"7260",2010,"Wyoming",1036,1413,26,94,2569
